1	W AH N
10	W AH N Z IY R OW
11	W AH N W AH N
12	W AH N T UW
13	W AH N TH R IY
14	W AH N F OW R
15	W AH N F AY V
15TH	W AH N F AY V T IY EY CH
16	W AH N S IH K S
17	W AH N S EH V AH N
18	W AH N EY T
18TH	EY T II N TH
19	W AH N AY N
2	T UW
20	T UW Z IY R OW
21	T UW W AH N
22	T UW T UW
23	T UW TH R IY
24	T UW F OW R
25	T UW F AY V
26	T UW S IH K S
26TH	T UW S IH K S T IY EY CH
27	T UW S EH V AH N
28	T UW EY T
29	T UW N AY N
3	TH R IY
30	TH R IY Z IY R OW
31	TH R IY W AH N
32	TH R IY T UW
33	TH R IY TH R IY
34	TH R IY F OW R
35	TH R IY F AY V
36	TH R IY S IH K S
37	TH R IY S EH V AH N
38	TH R IY EY T
39	TH R IY N AY N
4	F OW R
40	F OW R Z IY R OW
41	F OW R W AH N
42	F OW R T UW
43	F OW R TH R IY
44	F OW R F OW R
45	F OW R F AY V
46	F OW R S IH K S
47	F OW R S EH V AH N
48	F OW R EY T
49	F OW R N AY N
5	F AY V
50	F AY V Z IY R OW
51	F I F T II W axn
52	F I F T II T OO
53	F I F T II TH R II
54	F I F T II F OW R
55	F I F T II F AY V
56	F I F T II S I K S
57	F I F T II S EH V EH N
58	F I F T II EY T
59	F I F T II N AY N
6	S IH K S
60	S I K S T II
61	S I K S T II W axn
7	S EH V AH N
8	EY T
9	N AY N
A	AH
A(2)	EY
ABATEMENT	AH B EY T M AH N T
ABHORRENCE	AH B HH AO R AH N S
ABHORRENT	AE B HH AO R AH N T
ABIDE	AH B AY D
ABIDING	AH B AY D IH NG
ABILITIES	AH B IH L AH T IY Z
ABLE	EY B AH L
ABLUTION	AE B L OO SH axn
ABODE	AH B OW D
ABOMINABLE	AH B AA M AH N AH B AH L
ABOMINABLY	AE B AH M AH N AH B L IY
ABOMINATE	AX B AO M I N EY T
ABOUND	AH B AW N D
ABOUT	AH B AW T
ABOVE	AH B AH V
ABROAD	AH B R AO D
ABRUPT	AH B R AH P T
ABRUPTLY	AH B R AH P T L IY
ABRUPTNESS	AH B R AH P T N AH S
ABSENCE	AE B S AH N S
ABSENT	AE B S AH N T
ABSOLUTE	AE B S AH L UW T
ABSOLUTELY	AE B S AH L UW T L IY
ABSURD	AH B S ER D
ABSURDITIES	AH B S ER D AH T IY Z
ABSURDITY	AH B S ER D AH T IY
ABUNDANT	AH B AH N D AH N T
ABUNDANTLY	AH B AH N D AH N T L IY
ABUSE	AH B Y UW S
ABUSE(2)	AH B Y UW Z
ABUSED	AH B Y UW Z D
ABUSING	AH B Y UW Z IH NG
ABUSIVE	AH B Y UW S IH V
ACCEDE	AE K S IY D
ACCEDED	AE K S IY D IH D
ACCEDING	AE K S IY D IH NG
ACCENT	AH K S EH N T
ACCENT(2)	AE K S EH N T
ACCENTS	AE K S EH N T S
ACCEPT	AE K S EH P T
ACCEPT(2)	AH K S EH P T
ACCEPTABLE	AE K S EH P T AH B AH L
ACCEPTABLE(2)	AH K S EH P T AH B AH L
ACCEPTANCE	AE K S EH P T AH N S
ACCEPTANCE(2)	AH K S EH P T AH N S
ACCEPTED	AE K S EH P T IH D
ACCEPTED(2)	AH K S EH P T AH D
ACCEPTING	AE K S EH P T IH NG
ACCEPTING(2)	AH K S EH P T IH NG
ACCIDENT	AE K S AH D AH N T
ACCIDENTAL	AE K S AH D EH N T AH L
ACCIDENTAL(2)	AE K S AH D EH N AH L
ACCIDENTALLY	AE K S AH D EH N T AH L IY
ACCIDENTALLY(2)	AE K S AH D EH N AH L IY
ACCOMPANIED	AH K AH M P AH N IY D
ACCOMPANY	AH K AH M P AH N IY
ACCOMPANYING	AH K AH M P AH N IY IH NG
ACCOMPLISHED	AH K AA M P L IH SH T
ACCOMPLISHMENT	AH K AA M P L IH SH M AH N T
ACCOMPLISHMENTS	AH K AA M P L IH SH M AH N T S
ACCORDING	AH K AO R D IH NG
ACCORDINGLY	AH K AO R D IH NG L IY
ACCOSTED	AH K AA S T AH D
ACCOUNT	AH K AW N T
ACCOUNTED	AH K AW N T AH D
ACCOUNTED(2)	AH K AW N AH D
ACCOUNTING	AH K AW N T IH NG
ACCOUNTING(2)	AH K AW N IH NG
ACCOUNTS	AH K AW N T S
ACCURACY	AE K Y ER AH S IY
ACCURATE	AE K Y ER AH T
ACCUSATION	AE K Y AH Z EY SH AH N
ACCUSATION(2)	AE K Y UW Z EY SH AH N
ACCUSATIONS	AE K Y AH Z EY SH AH N Z
ACCUSATIONS(2)	AE K Y UW Z EY SH AH N Z
ACCUSE	AH K Y UW Z
ACCUSED	AH K Y UW Z D
ACCUSING	AH K Y UW Z IH NG
ACCUSTOMED	AH K AH S T AH M D
ACHED	EY K T
ACHIEVING	AH CH IY V IH NG
ACKNOWLEDGE	AE K N AA L IH JH
ACKNOWLEDGE(2)	IH K N AA L IH JH
ACKNOWLEDGED	AE K N AA L IH JH D
ACKNOWLEDGED(2)	IH K N AA L IH JH D
ACKNOWLEDGING	AE K N AA L IH JH IH NG
ACKNOWLEDGING(2)	IH K N AA L IH JH IH NG
ACKNOWLEDGMENT	AE K N AA L IH JH M AH N T
ACKNOWLEDGMENT(2)	IH K N AA L IH JH M AH N T
ACKNOWLEDGMENTS	AE K N AA L IH JH M AH N T S
ACQUAINT	AH K W EY N T
ACQUAINTANCE	AH K W EY N T AH N S
ACQUAINTANCES	AH K W EY N T AH N S IH Z
ACQUAINTED	AH K W EY N T IH D
ACQUAINTED(2)	AH K W EY N IH D
ACQUAINTING	AX K W EY N T I ng
ACQUIESCE	AE K W IY EH S
ACQUIESCENCE	AE K W IY EH S AH N S
ACQUIRE	AH K W AY ER
ACQUIRED	AH K W AY ER D
ACQUISITION	AE K W AH Z IH SH AH N
ACQUIT	AH K W IH T
ACRIMONY	AE K R IH M OW N IY
ACROSS	AH K R AO S
ACT	AE K T
ACTED	AE K T AH D
ACTED(2)	AE K T IH D
ACTING	AE K T IH NG
ACTION	AE K SH AH N
ACTIONS	AE K SH AH N Z
ACTIVE	AE K T IH V
ACTIVITY	AE K T IH V AH T IY
ACTIVITY(2)	AE K T IH V IH T IY
ACTUAL	AE K CH AH W AH L
ACTUAL(2)	AE K SH AH L
ACTUALLY	AE K CH AH W AH L IY
ACTUALLY(2)	AE K SH L IY
ACTUALLY(3)	AE K CH L IY
ACTUALLY(4)	AE K SH AH L IY
ACTUATED	AE K CH U EY T ed
ACUTE	AH K Y UW T
ACUTELY	AH K Y UW T L IY
ACUTEST	AX K Y OO T EH S T
ADAPTED	AH D AE P T AH D
ADAPTED(2)	AH D AE P T IH D
ADD	AE D
ADDED	AE D AH D
ADDED(2)	AE D IH D
ADDING	AE D IH NG
ADDITION	AH D IH SH AH N
ADDITIONAL	AH D IH SH AH N AH L
ADDITIONAL(2)	AH D IH SH N AH L
ADDITIONS	AH D IH SH AH N Z
ADDRESS	AE D R EH S
ADDRESS(2)	AH D R EH S
ADDRESSED	AH D R EH S T
ADDRESSES	AE D R EH S IH Z
ADDRESSES(2)	AH D R EH S IH Z
ADDRESSING	AH D R EH S IH NG
ADDS	AE D Z
ADEPT	AH D EH P T
ADEQUATE	AE D AH K W AH T
ADEQUATE(2)	AE D AH K W EY T
ADHERED	AE D HH IH R D
ADHERING	AH D HH IH R IH NG
ADIEU	AH D UW
ADIEUS	AH D Y UW Z
ADJUSTING	AH JH AH S T IH NG
ADMIRABLE	AE D M ER AH B AH L
ADMIRABLE(2)	AE D M R AH B AH L
ADMIRATION	AE D M ER EY SH AH N
ADMIRE	AE D M AY R
ADMIRED	AH D M AY ER D
ADMIRER	AE D M AY R ER
ADMIRES	AE D M AY R Z
ADMIRING	AE D M AY R IH NG
ADMISSION	AE D M IH SH AH N
ADMISSION(2)	AH D M IH SH AH N
ADMIT	AH D M IH T
ADMITTANCE	AH D M IH T AH N S
ADMITTED	AH D M IH T AH D
ADMITTING	AE D M IH T IH NG
ADMITTING(2)	AH D M IH T IH NG
ADOPT	AH D AA P T
ADOPTED	AH D AA P T AH D
ADORATION	AE D ER EY SH AH N
ADORNED	AH D AO R N D
ADVANCE	AH D V AE N S
ADVANCED	AH D V AE N S T
ADVANCEMENT	AH D V AE N S M AH N T
ADVANCES	AH D V AE N S AH Z
ADVANCES(2)	AH D V AE N S IH Z
ADVANTAGE	AE D V AE N T IH JH
ADVANTAGE(2)	AH D V AE N T IH JH
ADVANTAGE(3)	AE D V AE N IH JH
ADVANTAGE(4)	AH D V AE N AH JH
ADVANTAGEOUS	AE D V AH N T EY JH AH S
ADVANTAGEOUSLY	AX D V AE N T EY JH I AX S L II
ADVANTAGES	AE D V AE N T IH JH IH Z
ADVANTAGES(2)	AH D V AE N T IH JH IH Z
ADVANTAGES(3)	AE D V AE N IH JH IH Z
ADVANTAGES(4)	AH D V AE N IH JH IH Z
ADVENTURE	AE D V EH N CH ER
ADVENTURE(2)	AH D V EH N CH ER
ADVERTISED	AE D V ER T AY Z D
ADVICE	AE D V AY S
ADVICE(2)	AH D V AY S
ADVISABLE	AH D V AY Z AH B AH L
ADVISE	AE D V AY Z
ADVISE(2)	AH D V AY Z
ADVISED	AE D V AY Z D
ADVISED(2)	AH D V AY Z D
ADVISING	AE D V AY Z IH NG
AFFABILITY	AE F AH B IH L AH T EH
AFFABLE	AE F AH B AH L
AFFAIR	AH F EH R
AFFAIRS	AH F EH R Z
AFFECT	AH F EH K T
AFFECTATION	AE F EH K T EY SH AH N
AFFECTED	AH F EH K T AH D
AFFECTED(2)	AH F EH K T IH D
AFFECTION	AH F EH K SH AH N
AFFECTIONATE	AH F EH K SH AH N AH T
AFFECTIONATE(2)	AH F EH K SH AH N IH T
AFFECTIONATELY	AH F EH K SH AH N AH T L IY
AFFECTIONS	AH F EH K SH AH N Z
AFFINITY	AH F IH N AH T IY
AFFINITY(2)	AH F IH N IH T IY
AFFIRMATIVE	AH F ER M AH T IH V
AFFLICTED	AH F L IH K T AH D
AFFLICTED(2)	AH F L IH K T IH D
AFFLICTING	AH F L IH K T IH NG
AFFLICTION	AH F L IH K SH AH N
AFFORD	AH F AO R D
AFFORDED	AH F AO R D AH D
AFFORDING	AH F AO R D IH NG
AFFORDS	AH F AO R D Z
AFFRONT	AH F R AH N T
AFFRONTED	AH F R AH N T IH D
AFRAID	AH F R EY D
AFRESH	AH F R EH SH
AFTER	AE F T ER
AFTERNOON	AE F T ER N UW N
AFTERWARDS	AE F T ER W ER D Z
AGAIN	AH G EH N
AGAIN(2)	AH G EY N
AGAINST	AH G EH N S T
AGAINST(2)	AH G EY N S T
AGE	EY JH
AGITATED	AE JH AH T EY T AH D
AGITATION	AE JH AH T EY SH AH N
AGITATIONS	AE JH I T EY SH axn S
AGO	AH G OW
AGONIES	AE G AH N IY Z
AGONY	AE G AH N IY
AGREE	AH G R IY
AGREEABLE	AH G R IY AH B AH L
AGREEABLY	AH G R IY AH B L IY
AGREED	AH G R IY D
AGREEING	AH G R IY IH NG
AGREEMENT	AH G R IY M AH N T
AH	AA
AID	EY D
AIMED	EY M D
AIR	EH R
AIRING	EH R IH NG
AIRS	EH R Z
ALACRITY	AH L AE K R AH T IY
ALARM	AH L AA R M
ALARMED	AH L AA R M D
ALARMING	AH L AA R M IH NG
ALARMS	AH L AA R M Z
ALAS	AH L AE S
ALIENATED	EY L IY AH N EY T AH D
ALIENATED(2)	EY L IY AH N EY T IH D
ALIGHTED	AH L AY T IH D
ALIKE	AH L AY K
ALIVE	AH L AY V
ALL	AO L
ALLAYED	AH L EY D
ALLEVIATE	AH L IY V IY EY T
ALLEVIATED	AH L IY V IY EY T AH D
ALLEVIATED(2)	AH L IY V IY EY T IH D
ALLIANCE	AH L AY AH N S
ALLOW	AH L AW
ALLOWABLE	AH L AW AH B AH L
ALLOWANCE	AH L AW AH N S
ALLOWANCES	AH L AW AH N S IH Z
ALLOWED	AH L AW D
ALLOWING	AH L AW IH NG
ALLUDE	AH L UW D
ALLUDED	AH L UW D AH D
ALLUDING	AH L UW D IH NG
ALLUREMENTS	AX L Y OO ER M EH N TS
ALLUSION	AH L UW ZH AH N
ALLUSIONS	AH L UW ZH AH N Z
ALMOST	AO L M OW S T
ALONE	AH L OW N
ALONG	AH L AO NG
ALOOF	AH L UW F
ALOUD	AH L AW D
ALREADY	AO L R EH D IY
ALREADY(2)	AO R EH D IY
ALSO	AO L S OW
ALTAR	AO L T ER
ALTER	AO L T ER
ALTERATION	AO L T ER EY SH AH N
ALTERATIONS	AO L T ER EY SH AH N Z
ALTERED	AO L T ER D
ALTERNATE	AO L T ER N AH T
ALTERNATE(2)	AO L T ER N EY T
ALTERNATIVE	AO L T ER N AH T IH V
ALTHOUGH	AO L DH OW
ALTOGETHER	AO L T AH G EH DH ER
ALWAYS	AO L W EY Z
ALWAYS(2)	AO L W IY Z
AM	AE M
AM(2)	EY EH M
AMAZE	AH M EY Z
AMAZED	AH M EY Z D
AMAZEMENT	AH M EY Z M AH N T
AMAZES	AH M EY Z IH Z
AMAZING	AH M EY Z IH NG
AMBITION	AE M B IH SH AH N
AMENDMENT	AH M EH N D M AH N T
AMENDS	AH M EH N D Z
AMIABLE	EY M IY AH B AH L
AMID	AH M IH D
AMIDST	AH M IH D S T
AMISS	AH M IH S
AMONG	AH M AH NG
AMONGST	AH M AH NG S T
AMOUNT	AH M AW N T
AMOUNTING	AH M AW N T IH NG
AMOUNTING(2)	AH M AW N IH NG
AMPLE	AE M P AH L
AMPLY	AE M P L IY
AMUSE	AH M Y UW Z
AMUSED	AH M Y UW Z D
AMUSEMENT	AH M Y UW Z M AH N T
AMUSEMENTS	AH M Y UW Z M AH N T S
AMUSING	AH M Y UW Z IH NG
AN	AE N
AN(2)	AH N
ANCIENT	EY N CH AH N T
ANCIENT(2)	EY N SH AH N T
AND	AH N D
AND(2)	AE N D
ANECDOTE	AE N AH K D OW T
ANECDOTES	AE N AH K D OW T S
ANECDOTES(2)	AE N IH K D OW T S
ANEW	AH N UW
ANEW(2)	AH N Y UW
ANGEL	EY N JH AH L
ANGELIC	AE N JH EH L IH K
ANGER	AE NG G ER
ANGRILY	AE NG G R AH L IY
ANGRY	AE NG G R IY
ANGUISH	AE NG G W IH SH
ANIMAL	AE N AH M AH L
ANIMATED	AE N AH M EY T AH D
ANIMATED(2)	AE N AH M EY T IH D
ANIMATING	AE N AH M EY T IH NG
ANIMATION	AE N AH M EY SH AH N
ANKLE	AE NG K AH L
ANKLES	AE NG K AH L Z
ANNE	AE N
ANNE'S	AE N Z
ANNESLEY	AE N S L II
ANNEXED	AE N EH K S T
ANNEXED(2)	AH N EH K S T
ANNOUNCE	AH N AW N S
ANNOUNCED	AH N AW N S T
ANNOYED	AH N OY D
ANNUAL	AE N Y UW AH L
ANNUM	AE N AH M
ANOTHER	AH N AH DH ER
ANSWER	AE N S ER
ANSWERABLE	AE N S ER AH B AH L
ANSWERED	AE N S ER D
ANSWERING	AE N S ER IH NG
ANSWERS	AE N S ER Z
ANTAGONIST	AE N T AE G AH N AH S T
ANTE	AE N T IY
ANTICIPATE	AE N T IH S AH P EY T
ANTICIPATED	AE N T IH S AH P EY T AH D
ANTICIPATED(2)	AE N T IH S AH P EY T IH D
ANTICIPATING	AE N T IH S AH P EY T IH NG
ANTICIPATION	AE N T IH S AH P EY SH AH N
ANXIETY	AE NG Z AY AH T IY
ANXIOUS	AE NG K SH AH S
ANXIOUS(2)	AE NG SH AH S
ANXIOUSLY	AE NG K SH AH S L IY
ANY	EH N IY
ANYBODY	EH N IY B AH D IY
ANYBODY'S	EH N IY B AH D IY Z
ANYHOW	EH N IY HH AW
ANYONE	EH N IY W AH N
ANYTHING	EH N IY TH IH NG
ANYWHERE	EH N IY W EH R
ANYWHERE(2)	EH N IY HH W EH R
APACE	AH P EY S
APARTMENT	AH P AA R T M AH N T
APARTMENTS	AH P AA R T M AH N T S
APOLOGIES	AH P AA L AH JH IY Z
APOLOGISE	AH P AA L AH JH AY Z
APOLOGISED	AH P AA L AH JH IY Z D
APOLOGISING	AH P AA L AH JH IY Z IH NG
APOLOGY	AH P AA L AH JH IY
APOTHECARY	AH P AA TH AH K EH R IY
APPAREL	AH P AE R AH L
APPAREL(2)	AH P EH R AH L
APPARENT	AH P EH R AH N T
APPARENTLY	AH P EH R AH N T L IY
APPEAL	AH P IY L
APPEALS	AH P IY L Z
APPEAR	AH P IH R
APPEARANCE	AH P IH R AH N S
APPEARANCES	AH P IH R AH N S AH Z
APPEARED	AH P IH R D
APPEARING	AH P IH R IH NG
APPEARS	AH P IH R Z
APPEASE	AH P IY Z
APPEASED	AH P IY Z D
APPERTAIN	AE P ER T EY N
APPETITE	AE P AH T AY T
APPLICATION	AE P L AH K EY SH AH N
APPLIED	AH P L AY D
APPLIES	AH P L AY Z
APPLY	AH P L AY
APPLYING	AH P L AY IH NG
APPOINTED	AH P OY N T AH D
APPOINTED(2)	AH P OY N T IH D
APPOINTMENT	AH P OY N T M AH N T
APPREHENDED	AE P R IH HH EH N D AH D
APPREHENDING	AE P R IH HH EH N D IH NG
APPREHENSION	AE P R IH HH EH N SH AH N
APPREHENSIONS	AE P R IH HH EH N SH AH N Z
APPREHENSIVE	AE P R IH HH EH N S IH V
APPREHENSIVE(2)	AE P R IY HH EH N S IH V
APPROACH	AH P R OW CH
APPROACHED	AH P R OW CH T
APPROACHING	AH P R OW CH IH NG
APPROBATION	AE P R AH B EY SH AH N
APPROVE	AH P R UW V
APPROVED	AH P R UW V D
APRIL	EY P R AH L
APT	AE P T
ARCH	AA R CH
ARCHBISHOP	AA R CH B IH SH AH P
ARCHLY	AA R CH L IY
ARCHNESS	AA R CH N AH S
ARDENT	AA R D AH N T
ARDENTLY	AA R D AH N T L IY
ARE	AA R
ARE(2)	ER
ARGUED	AA R G Y UW D
ARGUING	AA R G Y UW IH NG
ARGUMENT	AA R G Y AH M AH N T
ARGUMENTS	AA R G Y AH M AH N T S
ARISE	ER AY Z
ARISEN	ER IH Z AH N
ARISING	ER AY Z IH NG
ARM	AA R M
ARMY	AA R M IY
AROSE	ER OW Z
AROUND	ER AW N D
AROUND(2)	ER AW N
AROUSED	ER AW Z D
ARRANGE	ER EY N JH
ARRANGED	ER EY N JH D
ARRANGEMENT	ER EY N JH M AH N T
ARRANGEMENTS	ER EY N JH M AH N T S
ARRANGES	ER EY N JH IH Z
ARRANGING	ER EY N JH IH NG
ARREAR	AH R IH ER
ARRESTED	ER EH S T AH D
ARRESTED(2)	ER EH S T IH D
ARRIVAL	ER AY V AH L
ARRIVE	ER AY V
ARRIVED	ER AY V D
ARRIVING	ER AY V IH NG
ARROGANCE	EH R AH G AH N S
ARROGANT	EH R AH G AH N T
ART	AA R T
ARTFUL	AA R T F AH L
ARTFULLY	AA R T F AH L IY
ARTICLE	AA R T AH K AH L
ARTICLE(2)	AA R T IH K AH L
ARTICLES	AA R T AH K AH L Z
ARTICLES(2)	AA R T IH K AH L Z
ARTIFICIAL	AA R T AH F IH SH AH L
ARTS	AA R T S
AS	AE Z
AS(2)	EH Z
ASCENDED	AH S EH N D AH D
ASCERTAIN	AE S ER T EY N
ASCERTAINING	AE S ER T EY N IH NG
ASHAMED	AH SH EY M D
ASHWORTH	AE SH W ER TH
ASIDE	AH S AY D
ASK	AE S K
ASKED	AE S K T
ASKED(2)	AE S T
ASKING	AE S K IH NG
ASPECT	AE S P EH K T
ASPERITY	AH S P EH R IH T IY
ASPIRE	AH S P AY R
ASSEMBLED	AH S EH M B AH L D
ASSEMBLIES	AH S EH M B L IY Z
ASSEMBLY	AH S EH M B L IY
ASSENT	AH S EH N T
ASSENTED	AH S EH N T IH D
ASSENTS	AE S EH N TS
ASSERT	AH S ER T
ASSERTED	AH S ER T AH D
ASSERTING	AH S ER T IH NG
ASSERTION	AH S ER SH AH N
ASSERTIONS	AH S ER SH AH N Z
ASSIDUOUS	AH S IH D W AH S
ASSIDUOUSLY	AH S IH D W AH S L IY
ASSIST	AH S IH S T
ASSISTANCE	AH S IH S T AH N S
ASSISTANT	AH S IH S T AH N T
ASSISTED	AH S IH S T AH D
ASSISTED(2)	AH S IH S T IH D
ASSISTING	AH S IH S T IH NG
ASSOCIATING	AH S OW S IY EY T IH NG
ASSUME	AH S UW M
ASSUMED	AH S UW M D
ASSURANCE	AH SH UH R AH N S
ASSURANCES	AH SH UH R AH N S IH Z
ASSURANCES(2)	AH SH UH R AH N T S IH Z
ASSURE	AH SH UH R
ASSURED	AH SH UH R D
ASSURING	AH SH UH R IH NG
ASTONISH	AH S T AA N IH SH
ASTONISHED	AH S T AA N IH SH T
ASTONISHMENT	AH S T AA N IH SH M AH N T
AT	AE T
ATE	EY T
ATONE	AH T OW N
ATONED	AH T OW N D
ATONEMENT	AH T OW N M AH N T
ATTACH	AH T AE CH
ATTACHED	AH T AE CH T
ATTACHMENT	AH T AE CH M AH N T
ATTACHMENTS	AH T AE CH M AH N T S
ATTACK	AH T AE K
ATTACKED	AH T AE K T
ATTACKS	AH T AE K S
ATTAINED	AH T EY N D
ATTEMPT	AH T EH M P T
ATTEMPTED	AH T EH M P T AH D
ATTEMPTING	AH T EH M P T IH NG
ATTEND	AH T EH N D
ATTENDANCE	AH T EH N D AH N S
ATTENDANT	AH T EH N D AH N T
ATTENDANTS	AH T EH N D AH N T S
ATTENDED	AH T EH N D AH D
ATTENDING	AH T EH N D IH NG
ATTENTION	AH T EH N SH AH N
ATTENTIONS	AH T EH N SH AH N Z
ATTENTIVE	AH T EH N T IH V
ATTENTIVELY	AH T EH N T IH V L IY
ATTICS	AE T IH K S
ATTITUDE	AE T AH T UW D
ATTORNEY	AH T ER N IY
ATTRACTED	AH T R AE K T AH D
ATTRACTION	AH T R AE K SH AH N
ATTRACTIONS	AH T R AE K SH AH N Z
ATTRIBUTE	AE T R AH B Y UW T
ATTRIBUTE(2)	AH T R IH B Y UW T
ATTRIBUTED	AH T R IH B Y AH T AH D
ATTRIBUTING	AH T R IH B Y AH T IH NG
AUDIBLE	AA D AH B AH L
AUDIENCE	AA D IY AH N S
AUDIENCE(2)	AO D IY AH N S
AUGHT	AO T
AUGMENT	AO G M EH N T
AUGMENTED	AA G M EH N T AH D
AUGUST	AA G AH S T
AUGUST(2)	AO G AH S T
AUNT	AE N T
AUNT(2)	AO N T
AUNT'S	AE N T S
AUNT'S(2)	AO N T S
AUNTS	AE N T S
AUNTS(2)	AO N T S
AUSTEN	AO S T IH N
AUSTERITY	AO S T EH R IH T IY
AUTHORISE	AO TH ER AY Z
AUTHORISED	AO TH ER IY Z D
AUTHORISING	AO TH ER AY Z I ng
AUTHORITATIVE	AH TH AO R AH T EY T IH V
AUTHORITY	AH TH AO R AH T IY
AUTHORIZED	AO TH ER AY Z D
AVAIL	AH V EY L
AVAILED	AH V EY L D
AVARICE	AE V ER AH S
AVENUE	AE V AH N UW
AVOID	AH V OY D
AVOIDANCE	AH V OY D AH N S
AVOIDED	AH V OY D AH D
AVOIDED(2)	AH V OY D IH D
AVOIDING	AH V OY D IH NG
AVOWAL	AH V AW AH L
AVOWED	AH V AW D
AWAITED	AH W EY T AH D
AWAITED(2)	AH W EY T IH D
AWAKE	AH W EY K
AWAKENED	AH W EY K AH N D
AWARE	AH W EH R
AWAY	AH W EY
AWE	AA
AWE(2)	AO
AWED	AO D
AWFUL	AA F AH L
AWFUL(2)	AO F AH L
AWKWARD	AA K W ER D
AWKWARD(2)	AO K W ER D
AWKWARDNESS	AO K W ER D N AH S
AWOKE	AH W OW K
AYE	AY
B	B IY
BACK	B AE K
BACKED	B AE K T
BACKGAMMON	B AE K G AE M AH N
BACKWARD	B AE K W ER D
BACKWARDS	B AE K W ER D Z
BAD	B AE D
BAGS	B AE G Z
BAKEWELL	B EY K W EH L
BALL	B AO L
BALLS	B AO L Z
BALM	B AA M
BALM(2)	B AA L M
BANDBOX	B AE N D B AO K S
BANISH	B AE N IH SH
BANISHED	B AE N IH SH T
BANKS	B AE NG K S
BARBAROUS	B AA R B ER AH S
BARBAROUSLY	B AA R B AH R AH S L IY
BARE	B EH R
BAREFACED	B EH R F EY S T
BARELY	B EH R L IY
BARNET	B AA R N IH T
BAROUCHE	B AH R AW CH
BASHFUL	B AE SH F AH L
BASIS	B EY S AH S
BASIS(2)	B EY S IH S
BASS	B AE S
BASS(2)	B EY S
BATH	B AE TH
BATHING	B EY DH IH NG
BATTLED	B AE T AH L D
BE	B IY
BEAR	B EH R
BEARING	B EH R IH NG
BEARS	B EH R Z
BEATINGS	B IY T IH NG Z
BEAUTEOUS	B Y OO T I AX S
BEAUTIES	B Y UW T IY Z
BEAUTIFUL	B Y UW T AH F AH L
BEAUTY	B Y UW T IY
BEAUX	B OW
BECAME	B IH K EY M
BECAME(2)	B IY K EY M
BECAUSE	B IH K AO Z
BECAUSE(2)	B IH K AH Z
BECAUSE(3)	B IH K AA Z
BECOME	B IH K AH M
BECOMES	B IH K AH M Z
BECOMING	B IH K AH M IH NG
BED	B EH D
BEDROOMS	B EH D R UW M Z
BEEN	B IH N
BEEN(2)	B AH N
BEFALL	B IH F AO L
BEFORE	B IH F AO R
BEFORE(2)	B IY F AO R
BEFOREHAND	B IH F AO R HH AE N D
BEFRIENDED	B IH F R EH N D IH D
BEG	B EH G
BEGAN	B IH G AE N
BEGAN(2)	B IY G AE N
BEGGED	B EH G D
BEGGING	B EH G IH NG
BEGIN	B IH G IH N
BEGINNING	B IH G IH N IH NG
BEGINS	B IH G IH N Z
BEGS	B EH G Z
BEGUN	B IH G AH N
BEGUN(2)	B EY G AH N
BEHALF	B IH HH AE F
BEHAVE	B IH HH EY V
BEHAVED	B IH HH EY V D
BEHAVES	B IH HH EY V Z
BEHAVIOR	B IH HH EY V Y ER
BEHAVIOUR	B IH HH EY V Y ER
BEHELD	B IH HH EH L D
BEHIND	B IH HH AY N D
BEHOLDING	B IH HH OW L D IH NG
BEING	B IY IH NG
BELIEF	B IH L IY F
BELIEVE	B IH L IY V
BELIEVED	B IH L IY V D
BELIEVES	B IH L IY V Z
BELIEVING	B IH L IY V IH NG
BELL	B EH L
BELONG	B IH L AO NG
BELONGED	B IH L AO NG D
BELONGING	B IH L AO NG IH NG
BELONGS	B IH L AO NG Z
BELOVED	B IH L AH V D
BELOVED(2)	B IH L AH V AH D
BELOW	B IH L OW
BELOW(2)	B IY L OW
BENCHES	B EH N CH IH Z
BENEATH	B IH N IY TH
BENEFICENCE	B AH N EH F AH S AH N S
BENEFICIAL	B EH N AH F IH SH AH L
BENEFIT	B EH N AH F IH T
BENEFITED	B EH N AH F IH T IH D
BENEFITING	B EH N AH F IH T IH NG
BENEFITS	B EH N AH F IH T S
BENEVOLENCE	B AH N EH V AH L AH N S
BENEVOLENT	B AH N EH V AH L AH N T
BENNET	B EH N IH T
BENNET'S	B EH N IH T S
BENNETS	B EH N EH TS
BENT	B EH N T
BEQUEATHED	B AH K W IY TH T
BEQUEST	B IH K W EH S T
BESIDES	B IH S AY D Z
BESIDES(2)	B IY S AY D Z
BEST	B EH S T
BESTOW	B IH S T OW
BESTOWED	B IH S T OW D
BESTOWING	B IH S T OW IH NG
BETRAY	B IH T R EY
BETRAYED	B IH T R EY D
BETS	B EH T S
BETTER	B EH T ER
BETWEEN	B IH T W IY N
BETWEEN(2)	B IY T W IY N
BEWAILED	B I W EY L D
BEWILDERED	B IH W IH L D ER D
BEWITCHED	B IH W IH CH T
BEWITCHING	B IH W IH CH IH NG
BEYOND	B IH AA N D
BEYOND(2)	B IY AO N D
BEYOND(3)	B IH AO N D
BID	B IH D
BIDDING	B IH D IH NG
BILLIARD	B IH L Y ER D
BILLS	B IH L Z
BINGLEY	B IH NG L IY
BINGLEY'S	B IH NG L IY Z
BINGLEYS	B I ng G L II Z
BIRDS	B ER D Z
BIRMINGHAM	B ER M IH NG HH AE M
BIRTH	B ER TH
BIT	B IH T
BITING	B AY T IH NG
BITTER	B IH T ER
BITTEREST	B IH T ER AH S T
BITTERLY	B IH T ER L IY
BITTERNESS	B IH T ER N AH S
BLACK	B L AE K
BLACKEN	B L AE K AH N
BLAME	B L EY M
BLAMEABLE	B L EY M AH B AH L
BLAMED	B L EY M D
BLAMELESS	B L EY M L AH S
BLAMELESSNESS	B L EY M L EH S N EH S
BLAMING	B L EY M IH NG
BLASTED	B L AE S T AH D
BLASTED(2)	B L AE S T IH D
BLEMISH	B L EH M IH SH
BLENHEIM	B L EH N HH AY M
BLESS	B L EH S
BLESSED	B L EH S T
BLESSING	B L EH S IH NG
BLIND	B L AY N D
BLINDED	B L AY N D IH D
BLINDS	B L AY N D Z
BLOTS	B L AA T S
BLOW	B L OW
BLOWN	B L OW N
BLOWSY	B L OW Z II
BLUE	B L UW
BLUSH	B L AH SH
BLUSHED	B L AH SH T
BLUSHING	B L AH SH IH NG
BOARD	B AO R D
BOAST	B OW S T
BOASTED	B OW S T AH D
BOASTED(2)	B OW S T IH D
BOASTING	B OW S T IH NG
BODIES	B AA D IY Z
BODY	B AA D IY
BOISTEROUSLY	B AO Y S T R AX S L II
BOLD	B OW L D
BOLDLY	B OW L D L IY
BONNET	B AA N AH T
BOOK	B UH K
BOOKS	B UH K S
BORDERED	B AO R D ER D
BORDERING	B AO R D ER IH NG
BORE	B AO R
BORN	B AO R N
BORNE	B AO R N
BORROW	B AA R OW
BORROWED	B AA R OW D
BOSOM	B UH Z AH M
BOSOMS	B OO Z AX M S
BOTH	B OW TH
BOTTLE	B AA T AH L
BOTTOM	B AA T AH M
BOUGHT	B AA T
BOUGHT(2)	B AO T
BOULANGER	B AW L AH NG ER
BOUND	B AW N D
BOUNDARY	B AW N D ER IY
BOUNDARY(2)	B AW N D R IY
BOUNDLESS	B AW N D L AH S
BOUNDS	B AW N D Z
BOUNTY	B AW N T IY
BOURGH	B AO R OW
BOURGH'S	B AO R OW S
BOW	B AW
BOW(2)	B OW
BOWED	B AW D
BOWED(2)	B OW D
BOWING	B OW IH NG
BOWING(2)	B AW IH NG
BOWL	B OW L
BOWS	B AW Z
BOWS(2)	B OW Z
BOX	B AA K S
BOXES	B AA K S AH Z
BOXES(2)	B AA K S IH Z
BOY	B OY
BOYS	B OY Z
BRACELETS	B R EY S L IH T S
BRAIN	B R EY N
BRAINS	B R EY N Z
BRANCH	B R AE N CH
BREACH	B R IY CH
BREAK	B R EY K
BREAKFAST	B R EH K F AH S T
BREAKFASTED	B R EH K F AE S T ed
BREAKING	B R EY K IH NG
BREAST	B R EH S T
BREATH	B R EH TH
BREATHED	B R IY DH D
BREATHING	B R IY DH IH NG
BREATHLESS	B R EH TH L AH S
BRED	B R EH D
BREEDING	B R IY D IH NG
BREVITY	B R EH V AH T IY
BRIBE	B R AY B
BRIBERY	B R AY B ER IY
BRIDE	B R AY D
BRIDEGROOM	B R AY D G R UW M
BRIDGE	B R IH JH
BRIEFLY	B R IY F L IY
BRIGHT	B R AY T
BRIGHTENED	B R AY T AH N D
BRIGHTENING	B R AY T AH N IH NG
BRIGHTENING(2)	B R AY T N IH NG
BRIGHTEST	B R AY T AH S T
BRIGHTON	B R AY T AH N
BRILLIANCY	B R IH L Y AH N S IY
BRING	B R IH NG
BRINGING	B R IH NG IH NG
BRINGS	B R IH NG Z
BRINK	B R IH NG K
BRITAIN	B R IH T AH N
BRITISH	B R IH T IH SH
BRITTLE	B R IH T AH L
BROAD	B R AO D
BROKE	B R OW K
BROKEN	B R OW K AH N
BROMLEY	B R AA M L IY
BROOKING	B R UH K IH NG
BROTHER	B R AH DH ER
BROTHER'S	B R AH DH ER Z
BROTHERLY	B R AH DH ER L IY
BROTHERS	B R AH DH ER Z
BROUGHT	B R AO T
BROW	B R AW
BROWN	B R AW N
BUILD	B IH L D
BUILDING	B IH L D IH NG
BUILT	B IH L T
BURNING	B ER N IH NG
BURNT	B ER N T
BURST	B ER S T
BURYING	B EH R IY IH NG
BUSILY	B IH Z AH L IY
BUSINESS	B IH Z N AH S
BUSINESS(2)	B IH Z N IH S
BUSTLE	B AH S AH L
BUSY	B IH Z IY
BUT	B AH T
BUTCHER'S	B UH CH ER Z
BUTLER	B AH T L ER
BUY	B AY
BUYING	B AY IH NG
BY	B AY
BYE	B AY
CAKE	K EY K
CALCULATE	K AE L K Y AH L EY T
CALCULATED	K AE L K Y AH L EY T AH D
CALCULATED(2)	K AE L K Y AH L EY T IH D
CALCULATION	K AE L K Y AH L EY SH AH N
CALICO	K AE L AH K OW
CALL	K AO L
CALLED	K AO L D
CALLING	K AO L IH NG
CALLS	K AO L Z
CALM	K AA M
CALM(2)	K AA L M
CALMLY	K AA M L IY
CALMLY(2)	K AA L M L IY
CALMNESS	K AA M N AH S
CALMNESS(2)	K AA L M N AH S
CAMBRIC	K AE M B R I K
CAMBRIDGE	K EY M B R IH JH
CAME	K EY M
CAMP	K AE M P
CAMPFUL	K AE M P F U L
CAN	K AE N
CAN(2)	K AH N
CANDID	K AE N D AH D
CANDID(2)	K AE N D IH D
CANDOUR	K AE N D ER
CANNOT	K AE N AA T
CANNOT(2)	K AH N AA T
CANVAS	K AE N V AH S
CANVASSED	K AE N V AH S T
CAPABLE	K EY P AH B AH L
CAPACITY	K AH P AE S AH T IY
CAPACITY(2)	K AH P AE S IH T IY
CAPERS	K EY P ER Z
CAPITAL	K AE P AH T AH L
CAPITAL(2)	K AE P IH T AH L
CAPRICE	K AH P R IY S
CAPTAIN	K AE P T AH N
CAPTIVATE	K AE P T IH V EY T
CAPTIVATED	K AE P T IH V EY T IH D
CAPTIVATING	K AE P T IH V EY T IH NG
CAPTIVATION	K AE P T I V EY SH axn
CARD	K AA R D
CARDS	K AA R D Z
CARE	K EH R
CARED	K EH R D
CAREFUL	K EH R F AH L
CAREFULLY	K EH R F AH L IY
CARELESS	K EH R L AH S
CARELESSNESS	K EH R L AH S N AH S
CARES	K EH R Z
CARING	K EH R IH NG
CAROLINE	K EH R AH L AY N
CAROLINE'S	K EH R AH L AY N Z
CARPETS	K AA R P AH T S
CARRIAGE	K AE R IH JH
CARRIAGE(2)	K EH R AH JH
CARRIAGES	K AE R IH JH IH Z
CARRIAGES(2)	K EH R AH JH AH Z
CARRIED	K AE R IY D
CARRIED(2)	K EH R IY D
CARRY	K AE R IY
CARRY(2)	K EH R IY
CARRYING	K AE R IY IH NG
CARRYING(2)	K EH R IY IH NG
CARTER	K AA R T ER
CARVED	K AA R V D
CASE	K EY S
CASES	K EY S AH Z
CASES(2)	K EY S IH Z
CASSINO	K AH S IY N OW
CAST	K AE S T
CASUAL	K AE ZH AH W AH L
CASUAL(2)	K AE ZH W AH L
CATCH	K AE CH
CATCHING	K AE CH IH NG
CATHERINE	K AE TH ER AH N
CATHERINE(2)	K AE TH ER IH N
CATHERINE(3)	K AE TH R IH N
CATHERINE'S	K AE TH R IH N Z
CAUGHT	K AA T
CAUGHT(2)	K AO T
CAUSE	K AA Z
CAUSE(2)	K AO Z
CAUSED	K AA Z D
CAUSED(2)	K AO Z D
CAUSES	K AA Z AH Z
CAUSES(2)	K AO Z IH Z
CAUTION	K AA SH AH N
CAUTION(2)	K AO SH AH N
CAUTIONING	K AO SH AH N IH NG
CAUTIOUS	K AO SH AH S
CAUTIOUSNESS	K AO SH AH S N AH S
CEASE	S IY S
CEASED	S IY S T
CEASELESS	S IY S L IH S
CELEBRATED	S EH L AH B R EY T AH D
CELEBRATED(2)	S EH L AH B R EY T IH D
CELERITY	S EH L EH B R I T II
CENSURE	S EH N SH ER
CENSURED	S EH N SH ER D
CENSURING	S EH N SH ER I ng
CENTS	S EH N T S
CENTS(2)	S EH N S
CEREMONIES	S EH R AH M OW N IY Z
CEREMONIOUS	S EH R AH M OW N IY AH S
CEREMONY	S EH R AH M OW N IY
CERTAIN	S ER T AH N
CERTAINLY	S ER T AH N L IY
CERTAINTY	S ER T AH N T IY
CESSATION	S EH S EY SH AH N
CHAGRIN	SH AH G R IH N
CHAIR	CH EH R
CHAISE	SH EY Z
CHALLENGE	CH AE L AH N JH
CHAMBER	CH EY M B ER
CHAMBERLAYNE	CH EY M B ER L EY N
CHAMBERMAID	CH EY M B ER M EY D
CHANCE	CH AE N S
CHANCED	CH AE N S T
CHANCES	CH AE N S AH Z
CHANCES(2)	CH AE N S IH Z
CHANGE	CH EY N JH
CHANGED	CH EY N JH D
CHANGES	CH EY N JH AH Z
CHANGES(2)	CH EY N JH IH Z
CHANGING	CH EY N JH IH NG
CHAPERON	SH AE P AH R OW N
CHAPTER	CH AE P T ER
CHARACTER	K EH R IH K T ER
CHARACTERISE	K AE R EH K T ER AY Z
CHARACTERISTIC	K EH R AH K T ER IH S T IH K
CHARACTERS	K AE R IH K T ER Z
CHARACTERS(2)	K EH R AH K T ER Z
CHARGE	CH AA R JH
CHARGED	CH AA R JH D
CHARITY	CH EH R IH T IY
CHARLES	CH AA R L Z
CHARLES(2)	CH AA R AH L Z
CHARLOTTE	SH AA R L AH T
CHARLOTTE'S	SH AA R L AH T S
CHARM	CH AA R M
CHARMING	CH AA R M IH NG
CHARMINGLY	CH AA R M IH NG L IY
CHARMS	CH AA R M Z
CHATSWORTH	CH AE T S W ER TH
CHATTY	CH AE T IY
CHEAP	CH IY P
CHEAPSIDE	CH II P S AY D
CHEAT	CH IY T
CHEATING	CH IY T IH NG
CHECK	CH EH K
CHECKED	CH EH K T
CHECKING	CH EH K IH NG
CHEEKS	CH IY K S
CHEERFUL	CH IH R F AH L
CHEERFULLY	CH IH R F AH L IY
CHEERFULLY(2)	CH IH R F L IY
CHEERFULNESS	CH IH ER F AH L N AH S
CHEERING	CH IH R IH NG
CHERISH	CH EH R IH SH
CHERISHED	CH EH R IH SH T
CHESTNUTS	CH EH S N AH T S
CHICKEN	CH IH K AH N
CHIEF	CH IY F
CHIEFLY	CH IY F L IY
CHILD	CH AY L D
CHILDHOOD	CH AY L D HH UH D
CHILDREN	CH IH L D R AH N
CHIMNEY	CH IH M N IY
CHIN	CH IH N
CHINA	CH AY N AH
CHOICE	CH OY S
CHOOSE	CH UW Z
CHOOSES	CH UW Z AH Z
CHOOSES(2)	CH UW Z IH Z
CHOOSING	CH UW Z IH NG
CHOSE	CH OW Z
CHOSEN	CH OW Z AH N
CHRISTENING	K R IH S AH N IH NG
CHRISTENING(2)	K R IH S N IH NG
CHRISTIAN	K R IH S CH AH N
CHRISTIAN(2)	K R IH S CH IH N
CHRISTMAS	K R IH S M AH S
CHURCH	CH ER CH
CIRCLE	S ER K AH L
CIRCLES	S ER K AH L Z
CIRCUIT	S ER K AH T
CIRCULATED	S ER K Y AH L EY T AH D
CIRCULATED(2)	S ER K Y AH L EY T IH D
CIRCULATING	S ER K Y AH L EY T IH NG
CIRCULATION	S ER K Y AH L EY SH AH N
CIRCUMSPECT	S ER K AH M S P EH K T
CIRCUMSPECTION	S ER K AH M S P EH K SH AH N
CIRCUMSTANCE	S ER K AH M S T AE N S
CIRCUMSTANCES	S ER K AH M S T AE N S AH Z
CIRCUMSTANCES(2)	S ER K AH M S T AE N S IH Z
CITY	S IH T IY
CIVIL	S IH V AH L
CIVILITIES	S AH V IH L AH T IY Z
CIVILITY	S AH V IH L AH T IY
CIVILLY	S IH V IH L IY
CLAIM	K L EY M
CLAIMED	K L EY M D
CLAIMS	K L EY M Z
CLAMOROUS	K L AE M ER AH S
CLAPHAM	K L AE F AH M
CLARKE'S	K L AA R K S
CLASS	K L AE S
CLEANSE	K L EH N Z
CLEAR	K L IH R
CLEARED	K L IH R D
CLEARER	K L IH R ER
CLEARING	K L IH R IH NG
CLEARLY	K L IH R L IY
CLEMENT'S	K L EH M EH N TS
CLERGY	K L ER JH IY
CLERGYMAN	K L ER JH IY M AH N
CLERGYMAN(2)	K L ER JH IY M AE N
CLERICAL	K L EH R AH K AH L
CLERICAL(2)	K L EH R IH K AH L
CLERK	K L ER K
CLEVER	K L EH V ER
CLOCK	K L AA K
CLOSE	K L OW S
CLOSE(2)	K L OW Z
CLOSED	K L OW Z D
CLOSELY	K L OW S L IY
CLOSER	K L OW S ER
CLOSER(2)	K L OW Z ER
CLOSEST	K L OW S AH S T
CLOSET	K L AA Z AH T
CLOSURE	K L OW ZH ER
CLOTHES	K L OW DH Z
CLOTHES(2)	K L OW Z
CLOUDED	K L AW D IH D
CLUE	K L UW
CLUMP	K L AH M P
CLUSTER	K L AH S T ER
COACH	K OW CH
COACHMAN	K OW CH M AH N
COARSE	K AO R S
COARSENESS	K OW R S N AH S
COAT	K OW T
COATS	K OW T S
COAXED	K OW K S T
COFFEE	K AA F IY
COFFEE(2)	K AO F IY
COGENT	K OW JH AH N T
COHERENT	K OW HH IH R AH N T
COINCIDE	K OW IH N S AY D
COINCIDED	K OW AH N S AY D AH D
COINCIDENCE	K OW IH N S IH D AH N S
COLD	K OW L D
COLDER	K OW L D ER
COLDLY	K OW L D L IY
COLDS	K OW L D Z
COLLECT	K AH L EH K T
COLLECTED	K AH L EH K T AH D
COLLECTING	K AH L EH K T IH NG
COLLECTION	K AH L EH K SH AH N
COLLINS	K AA L IH N Z
COLLINS'S	K AA L IH N Z IH Z
COLLINS'S(2)	K AA L IH N Z
COLLINSES	K AO L I N S ez
COLONEL	K ER N AH L
COLONEL'S	K ER N AH L Z
COLOUR	K AH L ER
COLOURED	K AH L ER D
COLOURING	K AH L ER IH NG
COMBATED	K AH M B AE T IH D
COME	K AH M
COMES	K AH M Z
COMFORT	K AH M F ER T
COMFORTABLE	K AH M F ER T AH B AH L
COMFORTABLY	K AH M F ER T AH B L IY
COMFORTED	K AH M F ER T IH D
COMFORTLESS	K AH M F ER T L AH S
COMFORTS	K AH M F ER T S
COMING	K AH M IH NG
COMMAND	K AH M AE N D
COMMANDED	K AH M AE N D AH D
COMMANDED(2)	K AH M AE N D IH D
COMMENCEMENT	K AH M EH N S M AH N T
COMMENDABLE	K AH M EH N D AH B AH L
COMMENDATION	K AA M AH N D EY SH AH N
COMMENDATIONS	K AO M EH N D EY SH axn S
COMMENDED	K AH M EH N D IH D
COMMERCE	K AA M ER S
COMMISERATION	K AH M IH Z ER EY SH AH N
COMMISSION	K AH M IH SH AH N
COMMISSIONED	K AH M IH SH AH N D
COMMISSIONING	K AH M IH SH AH N IH NG
COMMON	K AA M AH N
COMMONEST	K AA M AH N AH S T
COMMONLY	K AA M AH N L IY
COMMUNICATE	K AH M Y UW N AH K EY T
COMMUNICATED	K AH M Y UW N AH K EY T IH D
COMMUNICATION	K AH M Y UW N AH K EY SH AH N
COMMUNICATIONS	K AH M Y UW N AH K EY SH AH N Z
COMMUNICATIVE	K AH M Y UW N AH K AH T IH V
COMMUNICATIVENESS	K AX M Y OO N I K EY T I V N EH S
COMPANION	K AH M P AE N Y AH N
COMPANIONS	K AH M P AE N Y AH N Z
COMPANY	K AH M P AH N IY
COMPARATIVE	K AH M P EH R AH T IH V
COMPARATIVELY	K AH M P EH R AH T IH V L IY
COMPARE	K AH M P EH R
COMPARED	K AH M P EH R D
COMPARING	K AH M P EH R IH NG
COMPARISON	K AH M P EH R AH S AH N
COMPARISONS	K AH M P EH R AH S AH N Z
COMPASS	K AH M P AH S
COMPASSION	K AH M P AE SH AH N
COMPASSIONATE	K AH M P AE SH AH N AH T
COMPATIBLE	K AH M P AE T AH B AH L
COMPENSATION	K AA M P AH N S EY SH AH N
COMPETITION	K AA M P AH T IH SH AH N
COMPLACENCY	K AH M P L EY S AH N S IY
COMPLAIN	K AH M P L EY N
COMPLAINED	K AH M P L EY N D
COMPLAINING	K AH M P L EY N IH NG
COMPLAINT	K AH M P L EY N T
COMPLAINTS	K AH M P L EY N T S
COMPLAISANCE	K AH M P L EY S AH N S
COMPLAISANT	K AH M P L EY S AH N T
COMPLETE	K AH M P L IY T
COMPLETED	K AH M P L IY T AH D
COMPLETED(2)	K AH M P L IY T IH D
COMPLETELY	K AH M P L IY T L IY
COMPLETION	K AH M P L IY SH AH N
COMPLEXION	K AH M P EH K SH AH N
COMPLIANCE	K AH M P L AY AH N S
COMPLIED	K AH M P L AY D
COMPLIMENT	K AA M P L AH M EH N T
COMPLIMENTED	K AA M P L AH M EH N T IH D
COMPLIMENTING	K AA M P L AH M EH N T IH NG
COMPLIMENTS	K AA M P L AH M EH N T S
COMPLY	K AH M P L AY
COMPLYING	K AH M P L AY IH NG
COMPOSE	K AH M P OW Z
COMPOSED	K AH M P OW Z D
COMPOSEDLY	K AH M P OW Z AH D L IY
COMPOSITION	K AA M P AH Z IH SH AH N
COMPOSURE	K AH M P OW ZH ER
COMPREHEND	K AA M P R IY HH EH N D
COMPREHENDED	K AA M P R IH HH EH N D IH D
COMPREHENDS	K AO M P R I HH EH N D Z
COMPREHENSION	K AA M P R IY HH EH N SH AH N
COMPRISE	K AH M P R AY Z
COMPRISED	K AH M P R AY Z D
COMPROMISED	K AA M P R AH M AY Z D
CONCEAL	K AH N S IY L
CONCEALED	K AH N S IY L D
CONCEALING	K AH N S IY L IH NG
CONCEALMENT	K AH N S IY L M AH N T
CONCEALS	K AH N S IY L Z
CONCEIT	K AH N S IY T
CONCEITED	K AH N S IY T AH D
CONCEIVE	K AH N S IY V
CONCEPTION	K AH N S EH P SH AH N
CONCERN	K AH N S ER N
CONCERNED	K AH N S ER N D
CONCERNING	K AH N S ER N IH NG
CONCERNS	K AH N S ER N Z
CONCERTO	K AH N CH EH R T OW
CONCILIATE	K AH N S IH L IY EY T
CONCILIATING	K AH N S IH L IY EY T IH NG
CONCILIATORY	K AH N S IH L IY AH T AO R IY
CONCILIATORY(2)	K AH N S IH L Y AH T AO R IY
CONCISE	K AH N S AY S
CONCISELY	K AH N S AY S L IY
CONCLUDE	K AH N K L UW D
CONCLUDED	K AH N K L UW D AH D
CONCLUDED(2)	K AH N K L UW D IH D
CONCLUDING	K AH N K L UW D IH NG
CONCLUSION	K AH N K L UW ZH AH N
CONCURRENCE	K AH N K ER AH N S
CONDEMN	K AH N D EH M
CONDEMNED	K AH N D EH M D
CONDESCEND	K AA N D IH S EH N D
CONDESCENDED	K AO N D EH S EH N D ed
CONDESCENDINGLY	K AO N D EH S EH N D I ng L II
CONDESCENDS	K AO N D EH S EH N D Z
CONDESCENSION	K AA N D AH S EH N SH AH N
CONDITION	K AH N D IH SH AH N
CONDITIONAL	K AH N D IH SH AH N AH L
CONDITIONALLY	K AH N D IH SH AH N AH L IY
CONDITIONALLY(2)	K AH N D IH SH N AH L IY
CONDITIONS	K AH N D IH SH AH N Z
CONDOLE	K axn D OW L
CONDOLENCE	K AH N D OW L AH N S
CONDUCT	K AH N D AH K T
CONDUCT(2)	K AA N D AH K T
CONDUCTED	K AH N D AH K T AH D
CONFEDERACY	K AH N F EH D ER AH S IY
CONFEDERACY(2)	K AH N F EH D R AH S IY
CONFERENCE	K AA N F ER AH N S
CONFERENCE(2)	K AA N F R AH N S
CONFESS	K AH N F EH S
CONFESSED	K AH N F EH S T
CONFESSION	K AH N F EH SH AH N
CONFIDANTE	K AA N F AH D AE N T
CONFIDE	K AH N F AY D
CONFIDENCE	K AA N F AH D AH N S
CONFIDENT	K AA N F AH D AH N T
CONFIDENTIAL	K AA N F AH D EH N SH AH L
CONFIDENTIAL(2)	K AA N F AH D EH N CH AH L
CONFIDENTLY	K AA N F AH D AH N T L IY
CONFIDING	K AH N F AY D IH NG
CONFINED	K AH N F AY N D
CONFINEMENT	K AH N F AY N M AH N T
CONFIRM	K AH N F ER M
CONFIRMATION	K AA N F ER M EY SH AH N
CONFIRMED	K AH N F ER M D
CONFIRMING	K AH N F ER M IH NG
CONFIRMS	K AH N F ER M Z
CONFUSED	K AH N F Y UW Z D
CONFUSION	K AH N F Y UW ZH AH N
CONGENIAL	K AH N JH IY N Y AH L
CONGRATULATE	K AH N G R AE CH AH L EY T
CONGRATULATED	K AH N G R AE CH AH L EY T IH D
CONGRATULATION	K AH N G R AE CH AH L EY SH AH N
CONGRATULATIONS	K AH N G R AE CH AH L EY SH AH N Z
CONGRATULATORY	K AH N G R AE CH AH L AH T AO R IY
CONJECTURE	K AH N JH EH K CH ER
CONJECTURE(2)	K AH N JH EH K SH ER
CONJECTURED	K AH N JH EH K CH ER D
CONJECTURES	K AH N JH EH K CH ER Z
CONJECTURES(2)	K AH N JH EH K SH ER Z
CONJECTURING	K AH N JH EH K CH ER IH NG
CONJUGAL	K AA N JH AH G AH L
CONJUNCTION	K AH N JH AH NG K SH AH N
CONNECT	K AH N EH K T
CONNECTED	K AH N EH K T AH D
CONNECTED(2)	K AH N EH K T IH D
CONNECTION	K AH N EH K SH AH N
CONNECTIONS	K AH N EH K SH AH N Z
CONNIVANCE	K AH N AY V AH N S
CONNUBIAL	K AO N OO B I AX L
CONQUER	K AA NG K ER
CONQUERED	K AA NG K ER D
CONQUEST	K AA NG K W EH S T
CONSCIENCE	K AA N SH AH N S
CONSCIENTIOUS	K AA N SH IY EH N SH AH S
CONSCIENTIOUSLY	K AA N CH IY EH N CH AH S L IY
CONSCIOUS	K AA N SH AH S
CONSCIOUSNESS	K AA N SH AH S N AH S
CONSENT	K AH N S EH N T
CONSENTED	K AH N S EH N T IH D
CONSENTED(2)	K AH N S EH N IH D
CONSENTING	K AH N S EH N T IH NG
CONSENTING(2)	K AH N S EH N IH NG
CONSEQUENCE	K AA N S AH K W AH N S
CONSEQUENCES	K AA N S AH K W EH N S AH Z
CONSEQUENT	K AA N S AH K W AH N T
CONSEQUENTIAL	K AA N S AH K W EH N CH AH L
CONSEQUENTLY	K AA N S AH K W AH N T L IY
CONSEQUENTLY(2)	K AA N S AH K W EH N T L IY
CONSIDER	K AH N S IH D ER
CONSIDERABLE	K AH N S IH D ER AH B AH L
CONSIDERABLY	K AH N S IH D ER AH B L IY
CONSIDERATION	K AH N S IH D ER EY SH AH N
CONSIDERATIONS	K AH N S IH D ER EY SH AH N Z
CONSIDERED	K AH N S IH D ER D
CONSIDERING	K AH N S IH D ER IH NG
CONSIGN	K AH N S AY N
CONSIGNED	K AH N S AY N D
CONSISTED	K AH N S IH S T AH D
CONSISTED(2)	K AH N S IH S T IH D
CONSISTENCY	K AH N S IH S T AH N S IY
CONSISTENT	K AH N S IH S T AH N T
CONSISTS	K AH N S IH S T S
CONSISTS(2)	K AH N S IH S S
CONSISTS(3)	K AH N S IH S
CONSOLATION	K AA N S AH L EY SH AH N
CONSOLATORY	K AO N S OW L EY T OW R II
CONSOLE	K AA N S OW L
CONSOLE(2)	K AH N S OW L
CONSOLED	K AH N S OW L D
CONSOLING	K AH N S OW L IH NG
CONSTANCY	K AA N S T AH N S IY
CONSTANT	K AA N S T AH N T
CONSTANTLY	K AA N S T AH N T L IY
CONSTERNATION	K AA N S T ER N EY SH AH N
CONSTITUTE	K AA N S T AH T UW T
CONSTITUTION	K AA N S T AH T UW SH AH N
CONSTRAINED	K AH N S T R EY N D
CONSTRUCTION	K AH N S T R AH K SH AH N
CONSTRUED	K AH N S T R UW D
CONSTRUING	K AO N S T R OO I ng
CONSULT	K AH N S AH L T
CONSULTED	K AH N S AH L T AH D
CONSULTED(2)	K AH N S AH L T IH D
CONSULTING	K AH N S AH L T IH NG
CONTAIN	K AH N T EY N
CONTAINED	K AH N T EY N D
CONTAINING	K AH N T EY N IH NG
CONTAINS	K AH N T EY N Z
CONTEMPLATION	K AA N T AH M P L EY SH AH N
CONTEMPT	K AH N T EH M P T
CONTEMPTUOUSLY	K AH N T EH M P CH W AH S L IY
CONTENT	K AA N T EH N T
CONTENT(2)	K AH N T EH N T
CONTENTED	K AH N T EH N T AH D
CONTENTED(2)	K AH N T EH N T IH D
CONTENTMENT	K AH N T EH N T M AH N T
CONTENTS	K AA N T EH N T S
CONTENTS(2)	K AH N T EH N T S
CONTINUAL	K AH N T IH N Y UW AH L
CONTINUALLY	K AH N T IH N Y UW AH L IY
CONTINUALLY(2)	K AH N T IH N Y UW L IY
CONTINUANCE	K AH N T IH N Y UW AH N S
CONTINUE	K AH N T IH N Y UW
CONTINUED	K AH N T IH N Y UW D
CONTINUING	K AH N T IH N Y UW IH NG
CONTRACTED	K AA N T R AE K T AH D
CONTRADICT	K AA N T R AH D IH K T
CONTRADICTED	K AA N T R AH D IH K T AH D
CONTRADICTIONS	K AA N T R AH D IH K SH AH N Z
CONTRARIETY	K AO N T R AX R AY T II
CONTRARIWISE	K AO N T R AX R II W AY Z
CONTRARY	K AA N T R EH R IY
CONTRARY(2)	K AH N T R EH R IY
CONTRAST	K AA N T R AE S T
CONTRAST(2)	K AH N T R AE S T
CONTRASTED	K AH N T R AE S T AH D
CONTRIBUTE	K AH N T R IH B Y UW T
CONTRIBUTED	K AH N T R IH B Y UW T IH D
CONTRIVANCE	K AH N T R AY V AH N S
CONTRIVE	K AH N T R AY V
CONTRIVED	K AH N T R AY V D
CONTROVERTED	K AO N T R OW V ER T ed
CONVENIENCE	K AH N V IY N Y AH N S
CONVENIENT	K AH N V IY N Y AH N T
CONVERSATION	K AA N V ER S EY SH AH N
CONVERSATIONS	K AA N V ER S EY SH AH N Z
CONVERSE	K AA N V ER S
CONVERSE(2)	K AH N V ER S
CONVERSED	K AH N V ER S T
CONVERSIBLE	K axn V ER S I B xl
CONVERSING	K AH N V ER S IH NG
CONVERT	K AA N V ER T
CONVERT(2)	K AH N V ER T
CONVERTING	K AH N V ER T IH NG
CONVEY	K AH N V EY
CONVEYED	K AH N V EY D
CONVEYING	K AH N V EY IH NG
CONVICTION	K AH N V IH K SH AH N
CONVINCE	K AH N V IH N S
CONVINCED	K AH N V IH N S T
COOK	K UH K
COOKING	K UH K IH NG
COOKS	K UH K S
COOL	K UW L
COOLLY	K UW L IY
COPIED	K AA P IY D
COPPICE	K AO P I S
COPSE	K AO P S
COQUETRY	K AO K W EH T R II
CORDIAL	K AO R JH AH L
CORDIALITY	K AO R JH AH L AH T IY
CORDIALLY	K AO R JH AH L IY
CORNER	K AO R N ER
CORPS	K AO R
CORPS(2)	K AO R Z
CORRECT	K ER EH K T
CORRESPOND	K AO R AH S P AA N D
CORRESPONDENCE	K AO R AH S P AA N D AH N S
CORRESPONDENT	K AO R AH S P AA N D AH N T
CORRESPONDENTS	K AO R AH S P AA N D AH N T S
CORROBORATED	K ER AA B ER EY T IH D
CORROBORATION	K ER AO B ER EY SH AH N
CORRUPTION	K ER AH P SH AH N
COST	K AA S T
COST(2)	K AO S T
COSTING	K AO S T IH NG
COTTAGERS	K AO T EH JH ER S
COUGH	K AA F
COUGH(2)	K AO F
COUGHING	K AA F IH NG
COUGHING(2)	K AO F IH NG
COUGHS	K AO F S
COULD	K UH D
COUNTED	K AW N T AH D
COUNTED(2)	K AW N T IH D
COUNTED(3)	K AW N IH D
COUNTED(4)	K AW N AH D
COUNTENANCE	K AW N T AH N AH N S
COUNTERACT	K AW N T ER AE K T
COUNTERACTED	K AW N T ER AE K T IH D
COUNTERBALANCE	K AW N T ER B AE L AH N S
COUNTERBALANCE(2)	K AW N ER B AE L AH N S
COUNTERPART	K AW N T ER P AA R T
COUNTERPART(2)	K AW N ER P AA R T
COUNTING	K AW N T IH NG
COUNTING(2)	K AW N IH NG
COUNTRY	K AH N T R IY
COUNTY	K AW N T IY
COUNTY(2)	K AW N IY
COUPLE	K AH P AH L
COUPLES	K AH P AH L Z
COURAGE	K ER AH JH
COURAGE(2)	K ER IH JH
COURIER	K ER IY ER
COURSE	K AO R S
COURSES	K AO R S AH Z
COURSES(2)	K AO R S IH Z
COURT	K AO R T
COURTED	K AO R T IH D
COURTEOUS	K ER T IY AH S
COURTESY	K ER T AH S IY
COURTIER	K AO R T IY ER
COURTING	K AO R T IH NG
COURTSHIP	K AO R CH IH P
COUSIN	K AH Z AH N
COUSIN'S	K AH Z AH N Z
COUSINS	K AH Z AH N Z
COVER	K AH V ER
COVERED	K AH V ER D
COVERING	K AH V ER IH NG
COVERING(2)	K AH V R IH NG
COVIES	K OW V II S
COWS	K AW Z
CRADLES	K R EY D AH L Z
CRAMMED	K R AE M D
CRAYONS	K R EY AA N Z
CREATED	K R IY EY T AH D
CREATED(2)	K R IY EY T IH D
CREATIVE	K R IY EY T IH V
CREATURE	K R IY CH ER
CREATURES	K R IY CH ER Z
CREDIT	K R EH D AH T
CREDIT(2)	K R EH D IH T
CREDITABLE	K R EH D AH T AH B AH L
CREDITABLY	K R EH D AH T AH B L IY
CREDITORS	K R EH D IH T ER Z
CRIED	K R AY D
CRITICAL	K R IH T IH K AH L
CRITICISE	K R I T I S AY Z
CRITICISMS	K R IH T IH S IH Z AH M Z
CROSS	K R AO S
CROSSED	K R AO S T
CROSSING	K R AO S IH NG
CROWD	K R AW D
CROWDED	K R AW D AH D
CROWDED(2)	K R AW D IH D
CROWN	K R AW N
CROWNED	K R AW N D
CRUEL	K R UW AH L
CRUEL(2)	K R UW L
CRUELLY	K R UW L IY
CRUELTY	K R UW L T IY
CRUELTY(2)	K R UW AH L T IY
CRUSHING	K R AH SH IH NG
CRY	K R AY
CRYING	K R AY IH NG
CUCUMBER	K Y UW K AH M B ER
CULPRIT	K AH L P R IH T
CULTIVATION	K AH L T IH V EY SH AH N
CUNNING	K AH N IH NG
CUP	K AH P
CURE	K Y UH R
CURIOSITIES	K Y UH R IY AA S AH T IY Z
CURIOSITY	K Y UH R IY AA S AH T IY
CURIOUS	K Y UH R IY AH S
CURRICLE	K AH R AH K AH L
CURTAILED	K ER T EY L D
CURTAINS	K ER T AH N Z
CURTSEY	K ER T S II
CURTSEYED	K ER T S II D
CUSTODY	K AH S T AH D IY
CUSTOM	K AH S T AH M
CUTTING	K AH T IH NG
DAILY	D EY L IY
DALE	D EY L
DAMP	D AE M P
DANCE	D AE N S
DANCED	D AE N S T
DANCES	D AE N S AH Z
DANCES(2)	D AE N S IH Z
DANCING	D AE N S IH NG
DANGER	D EY N JH ER
DANGEROUS	D EY N JH ER AH S
DARCY	D AA R S IY
DARCY'S	D EY R S II S
DARE	D EH R
DARED	D EH R D
DARING	D EH R IH NG
DARK	D AA R K
DARLING	D AA R L IH NG
DARTING	D AA R T IH NG
DATE	D EY T
DATED	D EY T IH D
DAUGHTER	D AO T ER
DAUGHTER'S	D AO T ER Z
DAUGHTERS	D AO T ER Z
DAWDLED	D AO D AH L D
DAWSON	D AO S AH N
DAY	D EY
DAY'S	D EY Z
DAYS	D EY Z
DAZZLING	D AE Z AH L IH NG
DAZZLING(2)	D AE Z L IH NG
DE	D IY
DE(2)	D EY
DE(3)	D AH
DEAD	D EH D
DEADEN	D EH D AH N
DEAL	D IY L
DEAR	D IH R
DEAREST	D IH R AH S T
DEARLY	D IH R L IY
DEATH	D EH TH
DEBT	D EH T
DEBTS	D EH T S
DECAMPING	D II K AE M P I ng
DECEASE	D IH S IY S
DECEITFUL	D AH S IY T F AH L
DECEITFUL(2)	D IH S IY T F AH L
DECEIVE	D IH S IY V
DECEIVED	D IH S IY V D
DECEIVES	D I S II V Z
DECEIVING	D IH S IY V IH NG
DECENCY	D IY S AH N S IY
DECENT	D IY S AH N T
DECEPTION	D IH S EH P SH AH N
DECIDE	D IH S AY D
DECIDED	D IH S AY D IH D
DECIDEDLY	D IH S AY D AH D L IY
DECIDING	D AH S AY D IH NG
DECISIONS	D IH S IH ZH AH N Z
DECISIVE	D IH S AY S IH V
DECKED	D EH K T
DECLARATION	D EH K L ER EY SH AH N
DECLARE	D IH K L EH R
DECLARED	D IH K L EH R D
DECLARES	D IH K L EH R Z
DECLARING	D IH K L EH R IH NG
DECLINE	D IH K L AY N
DECLINED	D IH K L AY N D
DECORUM	D IH K AO R AH M
DECORUMS	D EH K OW R AX M S
DEDUCED	D IH D UW S T
DEEMED	D IY M D
DEEP	D IY P
DEEPER	D IY P ER
DEEPEST	D IY P AH S T
DEEPLY	D IY P L IY
DEFAULT	D IH F AO L T
DEFECT	D IY F EH K T
DEFECT(2)	D IH F EH K T
DEFECTION	D IH F EH K SH AH N
DEFECTIVE	D IH F EH K T IH V
DEFECTS	D IY F EH K T S
DEFECTS(2)	D IH F EH K T S
DEFENCE	D IH F EH N S
DEFEND	D IH F EH N D
DEFENDED	D IH F EH N D AH D
DEFENDED(2)	D IH F EH N D IH D
DEFENSE	D IH F EH N S
DEFER	D IH F ER
DEFERENCE	D EH F ER AH N S
DEFERENCE(2)	D EH F R AH N S
DEFERRED	D IH F ER D
DEFIANCE	D IH F AY AH N S
DEFICIENCY	D IH F IH SH AH N S IY
DEFICIENT	D IH F IH SH AH N T
DEFIED	D IH F AY D
DEFINED	D IH F AY N D
DEFINITION	D EH F AH N IH SH AH N
DEFY	D IH F AY
DEGENERATE	D IH JH EH N ER AH T
DEGENERATE(2)	D IH JH EH N ER EY T
DEGRADATION	D EH G R AH D EY SH AH N
DEGREE	D IH G R IY
DEGREES	D IH G R IY Z
DEIGNED	D EY N D
DEJECTION	D IH JH EH K SH AH N
DELAY	D IH L EY
DELAYED	D IH L EY D
DELIBERATED	D IH L IH B ER EY T IH D
DELIBERATELY	D IH L IH B ER AH T L IY
DELIBERATELY(2)	D IH L IH B R AH T L IY
DELIBERATION	D IH L IH B ER EY SH AH N
DELICACY	D EH L AH K AH S IY
DELICACY(2)	D EH L IH K AH S IY
DELICATE	D EH L AH K AH T
DELICIOUS	D IH L IH SH AH S
DELIGHT	D IH L AY T
DELIGHTED	D IH L AY T AH D
DELIGHTED(2)	D IH L AY T IH D
DELIGHTFUL	D IH L AY T F AH L
DELIGHTFULLY	D IH L AY T F AH L IY
DELIGHTING	D IH L AY T IH NG
DELIGHTS	D IH L AY T S
DELIVERED	D IH L IH V ER D
DELIVERING	D IH L IH V ER IH NG
DEMAND	D IH M AE N D
DEMANDING	D IH M AE N D IH NG
DEMANDS	D IH M AE N D Z
DEMEAN	D IH M IY N
DENIAL	D IH N AY AH L
DENIED	D IH N AY D
DENNY	D EH N IY
DENOMINATED	D IH N AA M AH N EY T IH D
DENOTED	D IH N OW T AH D
DENY	D IH N AY
DENYING	D IH N AY IH NG
DEPART	D IH P AA R T
DEPARTED	D IH P AA R T AH D
DEPARTED(2)	D IH P AA R T IH D
DEPARTURE	D IH P AA R CH ER
DEPEND	D IH P EH N D
DEPENDED	D IH P EH N D AH D
DEPENDED(2)	D IH P EH N D IH D
DEPENDENCE	D IH P EH N D AH N S
DEPENDENT	D IH P EH N D AH N T
DEPENDING	D IH P EH N D IH NG
DEPORTMENT	D AH P AO R T M AH N T
DEPRAVITY	D IH P R AE V AH T IY
DEPRECIATE	D IH P R IY SH IY EY T
DEPRESSED	D IH P R EH S T
DEPRIVE	D IH P R AY V
DEPRIVED	D IH P R AY V D
DERANGED	D IH R EY N JH D
DERBYSHIRE	D ER B II SH AY R
DERISION	D ER IH ZH AH N
DERIVE	D ER AY V
DERIVED	D ER AY V D
DERIVES	D ER AY V Z
DERIVES(2)	D IH R AY V Z
DESCENDED	D IH S EH N D AH D
DESCENDED(2)	D IH S EH N D IH D
DESCENDING	D IH S EH N D IH NG
DESCENT	D IH S EH N T
DESCRIBE	D IH S K R AY B
DESCRIBED	D IH S K R AY B D
DESCRIBING	D IH S K R AY B IH NG
DESCRIPTION	D IH S K R IH P SH AH N
DESERT	D EH Z ER T
DESERT(2)	D IH Z ER T
DESERTED	D IH Z ER T IH D
DESERTION	D IH Z ER SH AH N
DESERTS	D EH Z ER T S
DESERTS(2)	D IH Z ER T S
DESERVE	D IH Z ER V
DESERVED	D IH Z ER V D
DESERVEDLY	D IH Z ER V AH D L IY
DESERVES	D IH Z ER V Z
DESERVING	D IH Z ER V IH NG
DESIGN	D IH Z AY N
DESIGNED	D IH Z AY N D
DESIGNEDLY	D IH Z AY N AH D L IY
DESIGNING	D IH Z AY N IH NG
DESIGNS	D IH Z AY N Z
DESIRABLE	D IH Z AY R AH B AH L
DESIRABLE(2)	D IH Z AY ER AH B AH L
DESIRE	D IH Z AY ER
DESIRED	D IH Z AY ER D
DESIRING	D IH Z AY ER IH NG
DESIROUS	D IH Z AY R AH S
DESPAIR	D IH S P EH R
DESPAIRED	D IH S P EH R D
DESPERATE	D EH S P R IH T
DESPERATE(2)	D EH S P ER IH T
DESPERATION	D EH S P ER EY SH AH N
DESPERATION(2)	D EH S P ER EY SH IH N
DESPICABLE	D IH S P IH K AH B AH L
DESPICABLY	D EH S P I K EH B L II
DESPISE	D IH S P AY Z
DESPISED	D IH S P AY Z D
DESPISES	D IH S P AY Z IH Z
DESPISING	D IH S P AY Z IH NG
DESPONDING	D IH S P AA N D IH NG
DESTINED	D EH S T IH N D
DESTITUTE	D EH S T AH T UW T
DESTROYED	D IH S T R OY D
DESTRUCTIVE	D IH S T R AH K T IH V
DETACHED	D IH T AE CH T
DETACHED(2)	D IY T AE CH T
DETACHING	D I T AE CH I ng
DETAIL	D IH T EY L
DETAIL(2)	D IY T EY L
DETAILED	D IH T EY L D
DETAIN	D IH T EY N
DETAINED	D IH T EY N D
DETAINING	D IH T EY N IH NG
DETECT	D IH T EH K T
DETECTED	D IH T EH K T AH D
DETECTED(2)	D IH T EH K T IH D
DETECTION	D IH T EH K SH AH N
DETER	D IH T ER
DETERMINATION	D IH T ER M AH N EY SH AH N
DETERMINE	D AH T ER M AH N
DETERMINE(2)	D IH T ER M AH N
DETERMINED	D IH T ER M AH N D
DETERMINING	D IH T ER M AH N IH NG
DETEST	D IH T EH S T
DETEST(2)	D IY T EH S T
DETESTABLE	D IH T EH S T AH B AH L
DETESTED	D IH T EH S T IH D
DETESTED(2)	D IY T EH S T IH D
DEVELOP	D IH V EH L AH P
DEVELOPMENT	D IH V EH L AH P M AH N T
DEVICE	D IH V AY S
DEVOID	D IH V OY D
DEVOTE	D IH V OW T
DEVOTED	D IH V OW T AH D
DEVOTED(2)	D IH V OW T IH D
DEVOTING	D IH V OW T IH NG
DIALOGUE	D AY AH L AO G
DICTATE	D IH K T EY T
DICTATED	D IH K T EY T AH D
DICTATED(2)	D IH K T EY T IH D
DICTATES	D IH K T EY T S
DICTATING	D IH K T EY T IH NG
DICTATORIAL	D IH K T AH T AO R IY AH L
DID	D IH D
DIE	D AY
DIED	D AY D
DIFFER	D IH F ER
DIFFERENCE	D IH F ER AH N S
DIFFERENCE(2)	D IH F R AH N S
DIFFERENCES	D IH F ER AH N S IH Z
DIFFERENCES(2)	D IH F R AH N S AH Z
DIFFERENT	D IH F ER AH N T
DIFFERENT(2)	D IH F R AH N T
DIFFERENTLY	D IH F R AH N T L IY
DIFFERENTLY(2)	D IH F ER EH N T L IY
DIFFICULT	D IH F AH K AH L T
DIFFICULTY	D IH F AH K AH L T IY
DIFFICULTY(2)	D IH F IH K AH L T IY
DIFFIDENCE	D IH F AH D AH N S
DIFFIDENT	D IH F AH D AH N T
DIFFUSE	D IH F Y UW S
DIFFUSE(2)	D IH F Y UW Z
DIFFUSED	D IH F Y UW Z D
DIFFUSENESS	D I F Y OO Z N EH S
DIGNIFIED	D IH G N AH F AY D
DIGNITY	D IH G N AH T IY
DIGRESSIONS	D AY G R EH SH AH N Z
DILATORY	D IH L AH T AO R IY
DILIGENCE	D IH L AH JH AH N S
DILIGENCE(2)	D IH L IH JH AH N S
DIMENSIONS	D IH M EH N SH AH N Z
DIMINUTION	D IH M AH N UW SH AH N
DINE	D AY N
DINED	D AY N D
DINES	D AY N Z
DINING	D AY N IH NG
DINNER	D IH N ER
DINNERS	D IH N ER Z
DIRECT	D ER EH K T
DIRECT(2)	D AY R EH K T
DIRECT(3)	D IH R EH K T
DIRECTED	D ER EH K T AH D
DIRECTED(2)	D ER EH K T IH D
DIRECTED(3)	D AY R EH K T IH D
DIRECTED(4)	D IH R EH K T IH D
DIRECTING	D ER EH K T IH NG
DIRECTING(2)	D IY R EH K T IH NG
DIRECTING(3)	D AY R EH K T IH NG
DIRECTING(4)	D IH R EH K T IH NG
DIRECTION	D ER EH K SH AH N
DIRECTION(2)	D IY R EH K SH IH N
DIRECTION(3)	D AY R EH K SH IH N
DIRECTION(4)	D IH R EH K SH IH N
DIRECTIONS	D ER EH K SH AH N Z
DIRECTIONS(2)	D IY R EH K SH IH N Z
DIRECTIONS(3)	D AY R EH K SH IH N Z
DIRECTIONS(4)	D IH R EH K SH IH N Z
DIRECTLY	D ER EH K T L IY
DIRECTLY(2)	D IY R EH K L IY
DIRECTLY(3)	D AY R EH K L IY
DIRECTLY(4)	D IH R EH K L IY
DIRT	D ER T
DIRTY	D ER T IY
DISADVANTAGE	D IH S AH D V AE N T IH JH
DISADVANTAGE(2)	D IH S AH D V AE N IH JH
DISADVANTAGES	D IH S AH D V AE N T IH JH IH Z
DISADVANTAGES(2)	D IH S AH D V AE N IH JH Z
DISAGREEABLE	D IH S AH G R IY AH B AH L
DISAGREEABLY	D I S AX G R II AX B L II
DISAGREEMENT	D IH S AH G R IY M AH N T
DISAPPOINT	D IH S AH P OY N T
DISAPPOINTED	D IH S AH P OY N T IH D
DISAPPOINTED(2)	D IH S AH P OY N IH D
DISAPPOINTING	D IH S AH P OY N T IH NG
DISAPPOINTING(2)	D IH S AH P OY N IH NG
DISAPPOINTMENT	D IH S AH P OY N T M AH N T
DISAPPOINTMENTS	D IH S AH P OY N T M AH N T S
DISAPPROBATION	D IH S AE P R AH B EY SH AH N
DISAPPROVE	D IH S AH P R UW V
DISARM	D IH S AA R M
DISBELIEVING	D IH S B AH L IY V IH NG
DISCERN	D IH S ER N
DISCERNIBLE	D IH S ER N AH B AH L
DISCERNING	D IH S ER N IH NG
DISCERNMENT	D IH S ER N M AH N T
DISCHARGE	D IH S CH AA R JH
DISCHARGED	D IH S CH AA R JH D
DISCHARGING	D IH S CH AA R JH IH NG
DISCLAIM	D IH S K L EY M
DISCLAIMED	D IH S K L EY M D
DISCLOSE	D IH S K L OW Z
DISCLOSED	D IH S K L OW Z D
DISCLOSURE	D IH S K L OW ZH ER
DISCOMPOSE	D IH S K AH M P OW Z
DISCOMPOSED	D IH S K AH M P OW Z D
DISCOMPOSURE	D I S K AO M P OW SH ER
DISCONCERTED	D I S K AO N S ER T ed
DISCONTENTED	D IH S K AH N T EH N T IH D
DISCONTENTEDNESS	D I S K AO N T EH N T ed N EH S
DISCONTINUANCE	D IH S K AH N T IH N Y UW AH N S
DISCOURAGE	D IH S K ER IH JH
DISCOURAGED	D IH S K ER AH JH D
DISCOURAGED(2)	D IH S K ER IH JH D
DISCOURSE	D IH S K AO R S
DISCOURSES	D IH S K AO R S IH Z
DISCOVER	D IH S K AH V ER
DISCOVERED	D IH S K AH V ER D
DISCOVERING	D IH S K AH V ER IH NG
DISCOVERY	D IH S K AH V ER IY
DISCOVERY(2)	D IH S K AH V R IY
DISCREDIT	D IH S K R EH D AH T
DISCREDITABLE	D I S K R EH D I T AX B xl
DISCRETION	D IH S K R EH SH AH N
DISCRIMINATION	D IH S K R IH M AH N EY SH AH N
DISCUSS	D IH S K AH S
DISCUSSED	D IH S K AH S T
DISCUSSION	D IH S K AH SH AH N
DISDAIN	D IH S D EY N
DISDAINED	D IH S D EY N D
DISENGAGED	D IH S IH N G EY JH D
DISGRACE	D IH S G R EY S
DISGRACED	D IH S G R EY S T
DISGRACEFUL	D IH S G R EY S F AH L
DISGRACING	D IH S G R EY S IH NG
DISGUISE	D IH S G AY Z
DISGUST	D IH S G AH S T
DISGUSTED	D IH S G AH S T AH D
DISGUSTED(2)	D IH S G AH S T IH D
DISGUSTING	D IH S G AH S T IH NG
DISH	D IH SH
DISHEARTENED	D IH S HH AA R T AH N D
DISHES	D IH SH AH Z
DISHES(2)	D IH SH IH Z
DISHONEST	D IH S AA N AH S T
DISHONESTY	D IH S AA N AH S T IY
DISHONORABLE	D IH S AA N ER AH B AH L
DISHONOURABLE	D I S AO N AX R EH B AX L
DISINCLINATION	D IH S IH N K L AH N EY SH AH N
DISINCLINED	D IH S IH N K L AY N D
DISINTERESTED	D IH S IH N T R IH S T IH D
DISINTERESTED(2)	D IH S IH N R IH S T IH D
DISINTERESTEDNESS	D IH S IH N T R AH S T AH D N AH S
DISLIKE	D IH S L AY K
DISLIKED	D IH S L AY K T
DISLIKES	D IH S L AY K S
DISLIKING	D IH S L AY K IH NG
DISMAY	D IH S M EY
DISMISSED	D IH S M IH S T
DISMISSION	D I S M I SH axn
DISOBLIGING	D I S OW B L AY JH I ng
DISPATCHED	D IH S P AE CH T
DISPELLING	D IH S P EH L IH NG
DISPENSE	D IH S P EH N S
DISPIRITED	D IH S P IH R AH T IH D
DISPLAY	D IH S P L EY
DISPLAYED	D IH S P L EY D
DISPLAYING	D IH S P L EY IH NG
DISPLEASE	D IH S P L IY Z
DISPLEASED	D IH S P L IY Z D
DISPLEASURE	D IH S P L EH ZH ER
DISPOSAL	D IH S P OW Z AH L
DISPOSE	D IH S P OW Z
DISPOSED	D IH S P OW Z D
DISPOSING	D IH S P OW Z IH NG
DISPOSITION	D IH S P AH Z IH SH AH N
DISPOSITIONS	D IH S P AH Z IH SH AH N Z
DISPUTABLE	D IH S P Y UW T AH B AH L
DISPUTE	D IH S P Y UW T
DISPUTES	D IH S P Y UW T S
DISQUIET	D IH S K W AY AH T
DISREGARDED	D IH S R IH G AA R D IH D
DISRESPECT	D IH S R IH S P EH K T
DISRESPECTFUL	D IH S R IH S P EH K T F AH L
DISSATISFIED	D IH S AE T AH S F AY D
DISSEMBLE	D IH S EH M B AH L
DISSERVICE	D IH S ER V AH S
DISSIPATION	D IH S IH P EY SH AH N
DISSOLVED	D IH Z AA L V D
DISSUADE	D IH S W EY D
DISSUADED	D IH S W EY D IH D
DISTANCE	D IH S T AH N S
DISTANT	D IH S T AH N T
DISTINCTION	D IH S T IH NG K SH AH N
DISTINGUISH	D IH S T IH NG G W IH SH
DISTINGUISHED	D IH S T IH NG G W IH SH T
DISTINGUISHING	D IH S T IH NG G W IH SH IH NG
DISTRACTED	D IH S T R AE K T AH D
DISTRACTED(2)	D IH S T R AE K T IH D
DISTRACTEDLY	D IH S T R AE K T AH D L IY
DISTRACTION	D IH S T R AE K SH AH N
DISTRESS	D IH S T R EH S
DISTRESSED	D IH S T R EH S T
DISTRESSING	D IH S T R EH S IH NG
DISTRIBUTE	D IH S T R IH B Y UW T
DISTRUST	D IH S T R AH S T
DISTRUSTED	D IH S T R AH S T AH D
DISTRUSTED(2)	D IH S T R AH S T IH D
DISTURB	D IH S T ER B
DISTURBANCE	D IH S T ER B AH N S
DISTURBED	D IH S T ER B D
DISTURBERS	D I S T ER B ER S
DIVERSIFIED	D AY V ER S AH F AY D
DIVERSIFIED(2)	D IH V ER S AH F AY D
DIVERSION	D AY V ER ZH AH N
DIVERSION(2)	D IH V ER ZH AH N
DIVERT	D AY V ER T
DIVERT(2)	D IH V ER T
DIVERTED	D AY V ER T IH D
DIVERTED(2)	D IH V ER T IH D
DIVIDE	D IH V AY D
DIVIDED	D IH V AY D AH D
DIVIDING	D IH V AY D IH NG
DO	D UW
DOES	D AH Z
DOES(2)	D IH Z
DOING	D UW IH NG
DOINGS	D UW IH NG Z
DOLEFUL	D OW L F AH L
DOMAIN	D OW M EY N
DOMESTIC	D AH M EH S T IH K
DOMESTICS	D AH M EH S T IH K S
DON	D AA N
DONE	D AH N
DOOR	D AO R
DOORS	D AO R Z
DOORWAY	D AO R W EY
DOSE	D OW S
DOT	D AA T
DOUBLE	D AH B AH L
DOUBLED	D AH B AH L D
DOUBLY	D AH B L IY
DOUBT	D AW T
DOUBTED	D AW T IH D
DOUBTFUL	D AW T F AH L
DOUBTING	D AW T IH NG
DOUBTINGLY	D AW T IH NG L IY
DOUBTLESS	D AW T L AH S
DOUBTS	D AW T S
DOVE	D AH V
DOVE(2)	D OW V
DOVEDALE	D AX V D EY L
DOWN	D AW N
DOWNS	D AW N Z
DOWNSTAIRS	D AW N S T EH R Z
DOZEN	D AH Z AH N
DRAUGHTS	D R AE F T S
DRAW	D R AO
DRAWING	D R AO IH NG
DRAWINGS	D R AO IH NG Z
DRAWN	D R AO N
DREAD	D R EH D
DREADED	D R EH D IH D
DREADFUL	D R EH D F AH L
DREADFULLY	D R EH D F AH L IY
DREADING	D R EH D IH NG
DRESS	D R EH S
DRESSED	D R EH S T
DRESSES	D R EH S AH Z
DRESSES(2)	D R EH S IH Z
DRESSING	D R EH S IH NG
DREW	D R UW
DRILY	D R AY L II
DRINK	D R IH NG K
DRINKING	D R IH NG K IH NG
DRIVE	D R AY V
DRIVEN	D R IH V AH N
DRIVING	D R AY V IH NG
DROOPING	D R UW P IH NG
DROP	D R AA P
DROP(2)	D R AO P
DROPPED	D R AA P T
DROPT	D R AA P T
DROVE	D R OW V
DUCHESS	D AH CH AH S
DUCKS	D AH K S
DUCTILITY	D AH K T IH L AH T IY
DUE	D UW
DUE(2)	D Y UW
DUEL	D UW AH L
DUETS	D UW EH T S
DUETS(2)	D Y UW EH T S
DULL	D AH L
DULLEST	D AH L AH S T
DULLNESS	D AH L N AH S
DUPE	D UW P
DUPED	D UW P T
DUPLICITY	D UW P L IH S IH T IY
DURATION	D UH R EY SH AH N
DURING	D UH R IH NG
DURING(2)	D Y UH R IH NG
DURING(3)	D ER IH NG
DUTIES	D UW T IY Z
DUTIFULLY	D UW T IY F AH L IY
DUTY	D UW T IY
DUTY(2)	D Y UW T IY
DWELL	D W EH L
DWELLING	D W EH L IH NG
DWELT	D W EH L T
DYING	D AY IH NG
E	IY
EACH	IY CH
EAGER	IY G ER
EAGERLY	IY G ER L IY
EAGERNESS	IY G ER N AH S
EAR	IY R
EAR(2)	IH R
EARL	ER L
EARL'S	ER L S
EARLIER	ER L IY ER
EARLIEST	ER L IY AH S T
EARLY	ER L IY
EARNEST	ER N IH S T
EARNESTLY	ER N AH S T L IY
EARNESTNESS	ER N AH S T N AH S
EARTH	ER TH
EARTHLY	ER TH L IY
EASE	IY Z
EASILY	IY Z AH L IY
EASINESS	II Z I N EH S
EASTBOURNE	II S T B OW R N
EASTER	IY S T ER
EASY	IY Z IY
EAT	IY T
EATING	IY T IH NG
ECCENTRIC	IH K S EH N T R IH K
ECCENTRIC(2)	EH K S EH N T R IH K
ECHO	EH K OW
ECLAT	EY K L AA
ECLIPSED	IH K L IH P S T
ECLIPSED(2)	AH K L IH P S T
ECLIPSED(3)	IY K L IH P S T
ECONOMICALLY	EH K AH N AA M IH K L IY
ECONOMICALLY(2)	IY K AH N AA M IH K L IY
ECONOMY	IH K AA N AH M IY
ECONOMY(2)	IY K AA N AH M IY
ECSTASY	EH K S T AH S IY
EDGE	EH JH
EDGED	EH JH D
EDUCATED	EH JH AH K EY T AH D
EDUCATED(2)	EH JH Y UW K EY T AH D
EDUCATION	EH JH AH K EY SH AH N
EDUCATION(2)	EH JH Y UW K EY SH AH N
EDW	II D II D AX B AX L Y OO
EDWARD	EH D W ER D
EFFECT	IH F EH K T
EFFECT(2)	IY F EH K T
EFFECT(3)	AH F EH K T
EFFECTS	IH F EH K T S
EFFECTS(2)	IH F EH K S
EFFECTS(3)	IY F EH K T S
EFFECTS(4)	IY F EH K S
EFFECTUAL	IH F EH K CH AH W AH L
EFFECTUALLY	IH F EH K CH AH W AH L IY
EFFICACY	EH F IH K AE S IY
EFFORT	EH F ER T
EFFORTS	EH F ER T S
EFFUSION	IH F Y UW ZH AH N
EFFUSIONS	IH F Y UW ZH AH N Z
EIGHT	EY T
EITHER	IY DH ER
EITHER(2)	AY DH ER
ELAPSED	IH L AE P S T
ELATED	IH L EY T AH D
ELATED(2)	IH L EY T IH D
ELDER	EH L D ER
ELDERLY	EH L D ER L IY
ELDEST	EH L D AH S T
ELEGANCE	EH L AH G AH N S
ELEGANT	EH L AH G AH N T
ELEVATE	EH L AH V EY T
ELEVATED	EH L AH V EY T IH D
ELEVATING	EH L AH V EY T IH NG
ELEVATION	EH L AH V EY SH AH N
ELEVEN	IH L EH V AH N
ELEVEN(2)	IY L EH V AH N
ELIGIBILITY	EH L IH JH AH B IH L IH T IY
ELIGIBLE	EH L AH JH AH B AH L
ELIGIBLE(2)	EH L IH JH AH B AH L
ELIZA	IH L AY Z AH
ELIZABETH	IH L IH Z AH B AH TH
ELIZABETH(2)	IH L IH Z AH B IH TH
ELIZABETH'S	IH L IH Z AH B AH TH S
ELLIZABETH	EH L I Z AX B EH TH
ELOPE	IH L OW P
ELOPED	I L OW P T
ELOPEMENT	I L OW P M EH N T
ELOPING	IH L OW P IH NG
ELOQUENCE	EH L AH K W AH N S
ELOQUENT	EH L AH K W AH N T
ELSE	EH L S
ELSEWHERE	EH L S W EH R
ELUDED	IH L UW D IH D
EMBARGO	EH M B AA R G OW
EMBARRASSED	IH M B EH R AH S T
EMBARRASSMENT	IH M B EH R AH S M AH N T
EMBRACED	EH M B R EY S T
EMBRACING	EH M B R EY S IH NG
EMERGENCE	IH M ER JH AH N S
EMERGENCE(2)	IY M ER JH AH N S
EMINENCE	EH M AH N AH N S
EMINENT	EH M AH N AH N T
EMOTION	IH M OW SH AH N
EMOTION(2)	IY M OW SH AH N
EMOTIONS	IH M OW SH AH N Z
EMOTIONS(2)	IY M OW SH AH N Z
EMPHASIS	EH M F AH S AH S
EMPHASIS(2)	EH M F AH S IH S
EMPHATIC	EH M F AE T IH K
EMPHATICALLY	EH M F AE T IH K L IY
EMPHATICALLY(2)	EH M F AE T IH K AH L IY
EMPLOY	EH M P L OY
EMPLOY(2)	IH M P L OY
EMPLOYED	EH M P L OY D
EMPLOYED(2)	IH M P L OY D
EMPLOYING	EH M P L OY IH NG
EMPLOYING(2)	IH M P L OY IH NG
EMPLOYMENT	EH M P L OY M AH N T
EMPLOYMENT(2)	IH M P L OY M AH N T
EMPLOYMENTS	EH M P L OY M AH N T S
EMPLOYMENTS(2)	IH M P L OY M AH N T S
EMPTINESS	EH M P T IY N AH S
EMPTINESS(2)	EH M T IY N AH S
EMPTY	EH M P T IY
EMPTY(2)	EH M T IY
ENABLE	EH N EY B AH L
ENABLE(2)	IH N EY B AH L
ENABLED	EH N EY B AH L D
ENABLED(2)	IH N EY B AH L D
ENABLING	EH N EY B AH L IH NG
ENABLING(2)	IH N EY B AH L IH NG
ENABLING(3)	IH N EY B L IH NG
ENCAMPED	IH N K AE M P T
ENCOUNTER	IH N K AW N T ER
ENCOUNTER(2)	IH N K AW N ER
ENCOURAGE	EH N K ER IH JH
ENCOURAGE(2)	IH N K ER AH JH
ENCOURAGED	EH N K ER IH JH D
ENCOURAGED(2)	IH N K ER AH JH D
ENCOURAGEMENT	EH N K ER IH JH M AH N T
ENCOURAGING	EH N K ER IH JH IH NG
ENCOURAGING(2)	IH N K ER AH JH IH NG
ENCROACHING	IH N K R OW CH IH NG
ENCUMBRANCE	IH N K AH M B R AH N S
END	EH N D
ENDEARED	EH N D IY R D
ENDEAVOUR	IH N D EH V ER
ENDEAVOURED	IH N D IY AH V OW Y AH R D
ENDEAVOURING	IH N D IY AH V OW Y AH R AH NG
ENDEAVOURS	IH N D IY AH V OW Y AH R Z
ENDED	EH N D AH D
ENDED(2)	EH N D IH D
ENDLESS	EH N D L AH S
ENDURABLE	EH N D Y OO R AX B xl
ENDURE	EH N D Y UH R
ENDURE(2)	IH N D UH R
ENDURED	EH N D Y UH R D
ENDURED(2)	IH N D UH R D
ENDURING	EH N D Y UH R IH NG
ENDURING(2)	IH N D UH R IH NG
ENEMIES	EH N AH M IY Z
ENEMY	EH N AH M IY
ENERGETIC	EH N ER JH EH T IH K
ENERGY	EH N ER JH IY
ENFORCED	EH N F AO R S T
ENGAGE	EH N G EY JH
ENGAGED	EH N G EY JH D
ENGAGEMENT	EH N G EY JH M AH N T
ENGAGEMENTS	EH N G EY JH M AH N T S
ENGAGING	EH N G EY JH IH NG
ENGLAND	IH NG G L AH N D
ENGROSS	IH N G R OW S
ENGROSSED	IH N G R OW S T
ENGROSSING	IH N G R OW S IH NG
ENHANCE	EH N HH AE N S
ENJOY	EH N JH OY
ENJOY(2)	IH N JH OY
ENJOYING	EH N JH OY IH NG
ENJOYING(2)	IH N JH OY IH NG
ENJOYMENT	EH N JH OY M AH N T
ENJOYMENT(2)	IH N JH OY M AH N T
ENJOYMENTS	EH N JH OY M AH N T S
ENLARGING	IH N L AA R JH IH NG
ENNIGHT	EH N AY T
ENORMITY	IH N AO R M AH T IY
ENORMITY(2)	IY N AO R M AH T IY
ENOUGH	IH N AH F
ENOUGH(2)	IY N AH F
ENRAGED	EH N R EY JH D
ENRAGED(2)	IH N R EY JH D
ENSIGN	EH N S AH N
ENSIGNCY	EH N S AY N S II
ENSUE	IH N S UW
ENSUED	IH N S UW D
ENSUING	EH N S UW IH NG
ENSURE	EH N SH UH R
ENSURE(2)	IH N SH UH R
ENTAIL	EH N T EY L
ENTAILED	IH N T EY L D
ENTAILING	IH N T EY L IH NG
ENTER	EH N T ER
ENTER(2)	EH N ER
ENTERED	EH N T ER D
ENTERED(2)	EH N ER D
ENTERING	EH N T ER IH NG
ENTERING(2)	EH N ER IH NG
ENTERTAIN	EH N T ER T EY N
ENTERTAIN(2)	EH N ER T EY N
ENTERTAINED	EH N T ER T EY N D
ENTERTAINED(2)	EH N ER T EY N D
ENTERTAINMENT	EH N T ER T EY N M AH N T
ENTERTAINMENT(2)	EH N ER T EY N M AH N T
ENTIRELY	IH N T AY ER L IY
ENTITLED	EH N T AY T AH L D
ENTRANCE	EH N T R AH N S
ENTREAT	EH N T R IY T
ENTREATED	EH N T R IY T IH D
ENTREATIES	EH N T R IY T IY Z
ENTREATING	EH N T R II T I ng
ENTREATY	EH N T R IY T IY
ENUMERATING	EH N Y OO M ER EY T I ng
ENUMERATION	IH N UW M ER EY SH AH N
ENVELOPE	EH N V AH L OW P
ENVIED	EH N V IY D
ENVIRONS	IH N V AY R AH N Z
ENVY	EH N V IY
ENVYING	EH N V II I ng
EPITHET	EH P AH TH EH T
EPSOM	EH P S AH M
EQUAL	IY K W AH L
EQUALLED	IY K W AH L D
EQUALLY	IY K W AH L IY
EQUALS	IY K W AH L Z
EQUIPAGE	EH K W I P EY JH
EQUIVALENT	IH K W IH V AH L AH N T
EQUIVOCAL	IH K W IH V AH K AH L
ERE	EH R
ERR	EH R
ERR(2)	ER
ERRAND	EH R AH N D
ERROR	EH R ER
ERRORS	EH R ER Z
ESCAPE	IH S K EY P
ESCAPED	IH S K EY P T
ESCAPING	IH S K EY P IH NG
ESPECIALLY	AH S P EH SH L IY
ESPECIALLY(2)	AH S P EH SH AH L IY
ESQ	EH S
ESSENCE	EH S AH N S
ESSENTIAL	IH S EH N SH AH L
ESSENTIAL(2)	IY S EH N SH AH L
ESSENTIAL(3)	AH S EH N CH AH L
ESSENTIAL(4)	IY S EH N CH AH L
ESSENTIALS	EH S EH N CH AH L Z
ESSENTIALS(2)	IY S EH N CH AH L Z
ESSENTIALS(3)	EH S EH N SH AH L Z
ESSENTIALS(4)	IY S EH N SH AH L Z
ESTABLISH	IH S T AE B L IH SH
ESTABLISH(2)	IY S T AE B L IH SH
ESTABLISHED	IH S T AE B L IH SH T
ESTABLISHED(2)	IY S T AE B L IH SH T
ESTABLISHMENT	IH S T AE B L IH SH M AH N T
ESTABLISHMENT(2)	IY S T AE B L IH SH M AH N T
ESTATE	IH S T EY T
ESTATES	IH S T EY T S
ESTEEM	AH S T IY M
ESTEEMED	IH S T IY M D
ESTIMABLE	EH S T AH M AH B AH L
ESTIMATED	EH S T AH M EY T AH D
ESTIMATED(2)	EH S T AH M EY T IH D
ESTIMATION	EH S T AH M EY SH AH N
ETC	EH T S EH T ER AH
ETIQUETTE	EH T AH K AH T
EVADE	IH V EY D
EVADE(2)	IY V EY D
EVEN	IY V IH N
EVENING	IY V N IH NG
EVENING'S	IY V N IH NG Z
EVENINGS	IY V N IH NG Z
EVENNESS	IY V AH N N AH S
EVENT	IH V EH N T
EVENT(2)	IY V EH N T
EVENTS	IH V EH N T S
EVENTS(2)	IY V EH N T S
EVER	EH V ER
EVERY	EH V ER IY
EVERY(2)	EH V R IY
EVERYBODY	EH V R IY B AA D IY
EVERYBODY'S	EH V R IY B AA D IY Z
EVERYONE	EH V R IY W AH N
EVERYTHING	EH V R IY TH IH NG
EVERYWHERE	EH V R IY W EH R
EVERYWHERE(2)	EH V R IY HH W EH R
EVIDENT	EH V AH D AH N T
EVIDENTLY	EH V AH D AH N T L IY
EVIL	IY V AH L
EVILS	IY V AH L Z
EXACT	IH G Z AE K T
EXACTLY	IH G Z AE K T L IY
EXAGGERATE	IH G Z AE JH ER EY T
EXAGGERATION	IH G Z AE JH ER EY SH AH N
EXAMINATION	IH G Z AE M AH N EY SH AH N
EXAMINE	IH G Z AE M IH N
EXAMINED	IH G Z AE M AH N D
EXAMINING	IH G Z AE M IH N IH NG
EXAMPLE	IH G Z AE M P AH L
EXASPERATE	IH G Z AE S P ER EY T
EXCEED	IH K S IY D
EXCEEDED	IH K S IY D AH D
EXCEEDED(2)	IH K S IY D IH D
EXCEEDING	IH K S IY D IH NG
EXCEEDINGLY	IH K S IY D IH NG L IY
EXCEL	IH K S EH L
EXCELLENCE	EH K S AH L AH N S
EXCELLENCY	EH K S L EH N S IY
EXCELLENT	EH K S AH L AH N T
EXCEPT	IH K S EH P T
EXCEPTING	EH K S EH P T IH NG
EXCEPTION	IH K S EH P SH AH N
EXCEPTIONAL	IH K S EH P SH AH N AH L
EXCESS	EH K S EH S
EXCESS(2)	IH K S EH S
EXCESSIVE	IH K S EH S IH V
EXCESSIVELY	IH K S EH S IH V L IY
EXCHANGED	IH K S CH EY N JH D
EXCITE	IH K S AY T
EXCITED	IH K S AY T AH D
EXCITED(2)	IH K S AY T IH D
EXCITING	IH K S AY T IH NG
EXCLAIM	IH K S K L EY M
EXCLAIMED	IH K S K L EY M D
EXCLAIMING	IH K S K L EY M IH NG
EXCLAMATION	EH K S K L AH M EY SH AH N
EXCLAMATIONS	EH K S K L AH M EY SH AH N Z
EXCLUDE	IH K S K L UW D
EXCLUSION	IH K S K L UW ZH AH N
EXCUSE	IH K S K Y UW S
EXCUSE(2)	IH K S K Y UW Z
EXCUSED	IH K S K Y UW Z D
EXCUSES	IH K S K Y UW S IH Z
EXCUSES(2)	IH K S K Y UW Z IH Z
EXECUTED	EH K S AH K Y UW T AH D
EXECUTED(2)	EH K S AH K Y UW T IH D
EXECUTION	EH K S AH K Y UW SH AH N
EXECUTORS	IH G Z EH K Y AH T ER Z
EXERCISE	EH K S ER S AY Z
EXERCISING	EH K S ER S AY Z IH NG
EXERT	IH G Z ER T
EXERTED	IH G Z ER T IH D
EXERTING	IH G Z ER T IH NG
EXERTION	IH G Z ER SH AH N
EXHAUSTED	IH G Z AO S T AH D
EXHAUSTED(2)	IH G Z AO S T IH D
EXHIBIT	IH G Z IH B IH T
EXHIBITING	IH G Z IH B IH T IH NG
EXHIBITION	EH K S AH B IH SH AH N
EXIGENCE	IH G Z IH JH AH N S
EXIST	IH G Z IH S T
EXISTED	IH G Z IH S T AH D
EXISTENCE	EH G Z IH S T AH N S
EXISTENCE(2)	IH G Z IH S T AH N S
EXISTING	IH G Z IH S T IH NG
EXPECT	IH K S P EH K T
EXPECTATION	EH K S P EH K T EY SH AH N
EXPECTATIONS	EH K S P EH K T EY SH AH N Z
EXPECTED	IH K S P EH K T AH D
EXPECTED(2)	IH K S P EH K T IH D
EXPECTING	IH K S P EH K T IH NG
EXPECTS	IH K S P EH K T S
EXPECTS(2)	IH K S P EH K S
EXPEDIENT	IH K S P IY D IY AH N T
EXPEDITE	EH K S P IH D AY T
EXPEDITIOUSLY	EH K S P AH D IH SH AH S L IY
EXPENCE	EH K S P EH N S
EXPENCES	EH K S P EH N S ez
EXPENSE	IH K S P EH N S
EXPENSES	IH K S P EH N S AH Z
EXPENSES(2)	IH K S P EH N S IH Z
EXPERIENCE	IH K S P IH R IY AH N S
EXPERIENCED	IH K S P IH R IY AH N S T
EXPLAIN	IH K S P L EY N
EXPLAINED	IH K S P L EY N D
EXPLAINING	IH K S P L EY N IH NG
EXPLANATION	EH K S P L AH N EY SH AH N
EXPLANATIONS	EH K S P L AH N EY SH AH N Z
EXPLANATORY	IH K S P L AE N AH T AO R IY
EXPLICIT	IH K S P L IH S AH T
EXPLICITLY	IH K S P L IH S AH T L IY
EXPLORE	IH K S P L AO R
EXPOSE	IH K S P OW Z
EXPOSED	IH K S P OW Z D
EXPOSING	IH K S P OW Z IH NG
EXPOSTULATION	EH K S P AO S CH U L EY SH axn
EXPOSURE	IH K S P OW ZH ER
EXPRESS	IH K S P R EH S
EXPRESSED	IH K S P R EH S T
EXPRESSING	IH K S P R EH S IH NG
EXPRESSION	IH K S P R EH SH AH N
EXPRESSIONS	IH K S P R EH SH AH N Z
EXPRESSIVE	IH K S P R EH S IH V
EXPRESSIVELY	IH K S P R EH S IH V L IY
EXPRESSLY	EH K S P R EH S L IY
EXQUISITE	EH K S K W AH Z AH T
EXTENDED	IH K S T EH N D AH D
EXTENDED(2)	IH K S T EH N D IH D
EXTENSIVE	IH K S T EH N S IH V
EXTENT	IH K S T EH N T
EXTENUATING	IH K S T EH N Y UW EY T IH NG
EXTINGUISHED	IH K S T IH NG G W IH SH T
EXTORT	IH K S T AO R T
EXTORTED	IH K S T AO R T IH D
EXTRACTIONS	IH K S T R AE K SH AH N Z
EXTRACTS	IH K S T R AE K T S
EXTRACTS(2)	EH K S T R AE K T S
EXTRAORDINARY	IH K S T R AO R D AH N EH R IY
EXTRAORDINARY(2)	EH K S T R AH AO R D AH N EH R IY
EXTRAVAGANCE	IH K S T R AE V AH G AH N S
EXTRAVAGANT	IH K S T R AE V AH G AH N T
EXTREME	IH K S T R IY M
EXTREMELY	IH K S T R IY M L IY
EXUBERANCE	IH G Z UW B ER AH N S
EXUBERANT	IH G Z UW B ER AH N T
EXULTATION	EH K S AH L T EY SH AH N
EYE	AY
EYEING	AY IH NG
EYELASHES	AY L AE SH IH Z
EYES	AY Z
F	EH F
FACE	F EY S
FACED	F EY S T
FACES	F EY S AH Z
FACES(2)	F EY S IH Z
FACT	F AE K T
FACTS	F AE K T S
FACTS(2)	F AE K S
FACULTIES	F AE K AH L T IY Z
FAIL	F EY L
FAILED	F EY L D
FAILING	F EY L IH NG
FAILURE	F EY L Y ER
FAINT	F EY N T
FAINTER	F EY N T ER
FAINTLY	F EY N T L IY
FAIR	F EH R
FAIREST	F EH R IH S T
FAIRLY	F EH R L IY
FAITHFUL	F EY TH F AH L
FAITHFULLY	F EY TH F AH L IY
FALL	F AO L
FALL(2)	F AA L
FALLEN	F AA L AH N
FALLING	F AA L IH NG
FALLS	F AO L Z
FALSE	F AO L S
FALSEHOOD	F AE L S HH UH D
FALSELY	F AO L S L IY
FAME	F EY M
FAMILIAR	F AH M IH L Y ER
FAMILIARITY	F AH M IH L Y EH R AH T IY
FAMILIARLY	F AH M IH L Y ER L IY
FAMILIES	F AE M AH L IY Z
FAMILIES(2)	F AE M L IY Z
FAMILY	F AE M AH L IY
FAMILY(2)	F AE M L IY
FANCIED	F AE N S IY D
FANCY	F AE N S IY
FANCYING	F AE N S IY IH NG
FAR	F AA R
FARE	F EH R
FAREWELL	F EH R W EH L
FARM	F AA R M
FARMHOUSE	F AA R M HH AW S
FARTHER	F AA R DH ER
FARTHING	F AA R DH IH NG
FASHION	F AE SH AH N
FASHIONABLE	F AE SH AH N AH B AH L
FASHIONABLE(2)	F AE SH N AH B AH L
FASHIONS	F AE SH AH N Z
FAST	F AE S T
FASTENED	F AE S AH N D
FASTIDIOUS	F AE S T IH D IY AH S
FAT	F AE T
FATE	F EY T
FATHER	F AA DH ER
FATHER'S	F AA DH ER Z
FATIGUE	F AH T IY G
FATIGUED	F AH T IY G D
FAULT	F AO L T
FAULTLESS	F AO L T L AH S
FAULTS	F AO L T S
FAULTY	F AO L T IY
FAVOR	F EY V ER
FAVOUR	F EY V ER
FAVOURABLE	F EY V ER AH B AH L
FAVOURABLY	F EY V ER AH B L IY
FAVOURED	F EY V ER D
FAVOURITE	F AE V AH R AY T
FAVOURITE'S	F EY V R I T S
FAVOURITES	F AE V AH R AY T S
FAVOURS	F EY V ER S
FEAR	F IH R
FEARED	F IH R D
FEARFUL	F IH R F AH L
FEARING	F IH R IH NG
FEARLESS	F IH R L AH S
FEARS	F IH R Z
FEATHER	F EH DH ER
FEATHERS	F EH DH ER Z
FEATURE	F IY CH ER
FEATURES	F IY CH ER Z
FEBRUARY	F EH B Y UW W EH R IY
FEBRUARY(2)	F EH B R UW W EH R IY
FEEL	F IY L
FEELING	F IY L IH NG
FEELINGLY	F IY L IH NG L IY
FEELINGS	F IY L IH NG Z
FEELS	F IY L Z
FEET	F IY T
FELICITATIONS	F IH L IH S AH T EY SH AH N Z
FELICITY	F IH L IH S AH T IY
FELL	F EH L
FELLOW	F EH L OW
FELLOW'S	F EH L OW Z
FELLOWS	F EH L OW Z
FELT	F EH L T
FEMALE	F IY M EY L
FEMALES	F IY M EY L Z
FENDER	F EH N D ER
FERVENT	F ER V AH N T
FERVENTLY	F ER V AH N T L IY
FETCH	F EH CH
FETCHED	F EH CH T
FEVERISH	F IY V ER IH SH
FEW	F Y UW
FEWER	F Y UW ER
FIDGET	F IH JH IH T
FIDGETS	F IH JH AH T S
FIDGETY	F I JH EH T II
FIELD	F IY L D
FIELDS	F IY L D Z
FIFTEEN	F IH F T IY N
FIFTH	F IH F TH
FIFTH(2)	F IH TH
FIFTY	F IH F T IY
FIGHT	F AY T
FIGHTING	F AY T IH NG
FIGURE	F IH G Y ER
FIGURES	F IH G Y ER Z
FILIAL	F IH L IY AH L
FILL	F IH L
FILLED	F IH L D
FILLING	F IH L IH NG
FINAL	F AY N AH L
FINALLY	F AY N AH L IY
FINANCES	F IH N AE N S IH Z
FINANCES(2)	F AY N AE N S IH Z
FIND	F AY N D
FINDING	F AY N D IH NG
FINDS	F AY N D Z
FINE	F AY N
FINER	F AY N ER
FINERY	F AY N ER IY
FINEST	F AY N AH S T
FINGERING	F IH NG G ER IH NG
FINGERS	F IH NG G ER Z
FINISH	F IH N IH SH
FINISHED	F IH N IH SH T
FINISHING	F IH N IH SH IH NG
FIRE	F AY ER
FIRE(2)	F AY R
FIREPLACE	F AY ER P L EY S
FIRM	F ER M
FIRMEST	F ER M AH S T
FIRMLY	F ER M L IY
FIRMNESS	F ER M N AH S
FIRST	F ER S T
FISH	F IH SH
FISHING	F IH SH IH NG
FIT	F IH T
FITTED	F IH T AH D
FITTED(2)	F IH T IH D
FITZWILLIAM	F IH T S W IH L Y AH M
FITZWILLIAM'S	F I TS W I L I AX M S
FIVE	F AY V
FIX	F IH K S
FIXED	F IH K S T
FIXING	F IH K S IH NG
FLAMING	F L EY M IH NG
FLAT	F L AE T
FLATTER	F L AE T ER
FLATTERED	F L AE T ER D
FLATTERING	F L AE T ER IH NG
FLEW	F L UW
FLIGHT	F L AY T
FLIRT	F L ER T
FLIRTATION	F L ER T EY SH AH N
FLIRTING	F L ER T IH NG
FLOGGED	F L AO G D
FLOW	F L OW
FLOWED	F L OW D
FLOWING	F L OW IH NG
FLUCTUATING	F L AH K CH AH W EY T IH NG
FLUENTLY	F L UW AH N T L IY
FLUTTER	F L AH T ER
FLUTTERED	F L AH T ER D
FLUTTERINGS	F L AX T ER I ng Z
FLYING	F L AY IH NG
FOLDED	F OW L D AH D
FOLDED(2)	F OW L D IH D
FOLIOS	F OW L I OW S
FOLLIES	F AA L IY Z
FOLLOW	F AA L OW
FOLLOWED	F AA L OW D
FOLLOWING	F AA L OW IH NG
FOLLOWS	F AA L OW Z
FOLLY	F AA L IY
FOND	F AA N D
FONDER	F AA N D ER
FOOD	F UW D
FOOL	F UW L
FOOL'S	F UW L Z
FOOLISH	F UW L IH SH
FOOT	F UH T
FOOTING	F UH T IH NG
FOOTMAN	F UH T M AH N
FOOTSTOOL	F U T S T OO L
FOR	F AO R
FOR(2)	F ER
FOR(3)	F R ER
FORBADE	F ER B EY D
FORBEARANCE	F AO R B EH R AH N S
FORBEARING	F AO R B EH R I ng
FORBID	F ER B IH D
FORBID(2)	F AO B IH D
FORBIDDING	F ER B IH D IH NG
FORBIDDING(2)	F AO B IH D IH NG
FORBORE	F AO R B AO R
FORCE	F AO R S
FORCED	F AO R S T
FORCIBLY	F AO R S AH B L IY
FORCING	F AO R S IH NG
FORDYCE'S	F AO R D AY S
FOREGO	F AO R G OW
FORESAW	F AO R S AO
FORESEE	F AO R S IY
FORESEEN	F AO R S IY N
FORETOLD	F AO R T OW L D
FOREVER	F ER EH V ER
FORFEIT	F AO R F IH T
FORFEITED	F AO R F IH T IH D
FORLORN	F ER L AO R N
FORM	F AO R M
FORMAL	F AO R M AH L
FORMALITY	F AO R M AE L AH T IY
FORMATION	F AO R M EY SH AH N
FORMED	F AO R M D
FORMER	F AO R M ER
FORMERLY	F AO R M ER L IY
FORMIDABLE	F AO R M AH D AH B AH L
FORMIDABLE(2)	F AO R M IH D AH B AH L
FORMING	F AO R M IH NG
FORMS	F AO R M Z
FORSTER	F AO R S T ER
FORSTER'S	F AO R S T ER Z
FORSTERS	F AO R S T ER S
FORTH	F AO R TH
FORTITUDE	F AO R T IH T UW D
FORTNIGHT	F AO R T N AY T
FORTNIGHT'S	F AO R T N AY T S
FORTUNATE	F AO R CH AH N AH T
FORTUNATE(2)	F AO R CH UW N AH T
FORTUNATELY	F AO R CH AH N AH T L IY
FORTUNATELY(2)	F AO R CH UW N AH T L IY
FORTUNE	F AO R CH AH N
FORTUNE(2)	F AO R CH UW N
FORTUNES	F AO R CH AH N Z
FORTUNES(2)	F AO R CH UW N Z
FORTY	F AO R T IY
FORWARD	F AO R W ER D
FORWARDED	F AO R W ER D IH D
FORWARDER	F AO R W ER D ER
FORWARDING	F AO R W ER D IH NG
FORWARDS	F AO R W ER D Z
FOUL	F AW L
FOUND	F AW N D
FOUNDATION	F AW N D EY SH AH N
FOUNDATIONS	F AW N D EY SH AH N Z
FOUNDED	F AW N D AH D
FOUNDED(2)	F AW N D IH D
FOUR	F AO R
FOURTH	F AO R TH
FOURTHLY	F AO R TH L IY
FOXHOUNDS	F AO K S HH AW N D Z
FRAILTY	F R EY L T IY
FRAME	F R EY M
FRANKLY	F R AE NG K L IY
FRANKNESS	F R AE NG K N AH S
FRECKLED	F R EH K AH L D
FREE	F R IY
FREEDOM	F R IY D AH M
FREELY	F R IY L IY
FRENCH	F R EH N CH
FREQUENT	F R IY K W AH N T
FREQUENT(2)	F R IY K W EH N T
FREQUENTLY	F R IY K W AH N T L IY
FREQUENTLY(2)	F R IY K W EH N T L IY
FRESH	F R EH SH
FRESHER	F R EH SH ER
FRET	F R EH T
FRETFULLY	F R EH T F U L II
FRETFULNESS	F R EH T F U L N EH S
FRIDAY	F R AY D IY
FRIDAY(2)	F R AY D EY
FRIEND	F R EH N D
FRIEND'S	F R EH N D Z
FRIEND'S(2)	F R EH N Z
FRIENDLESS	F R EH N D L EH S
FRIENDLIER	F R EH N D L IY ER
FRIENDLIER(2)	F R EH N L IY ER
FRIENDLY	F R EH N D L IY
FRIENDLY(2)	F R EH N L IY
FRIENDS	F R EH N D Z
FRIENDS(2)	F R EH N Z
FRIENDSHIP	F R EH N D SH IH P
FRIENDSHIP(2)	F R EH N SH IH P
FRIGHTED	F R AY T ed
FRIGHTEN	F R AY T AH N
FRIGHTENED	F R AY T AH N D
FRISKS	F R I S K S
FRIVOLOUS	F R IH V AH L AH S
FROM	F R AH M
FROM(2)	F ER M
FRONT	F R AH N T
FRONTED	F R AH N T IH D
FROST	F R AO S T
FRUIT	F R UW T
FRUITS	F R UW T S
FUGITIVES	F Y UW JH IH T IH V Z
FULFIL	F UH L F AH L
FULL	F UH L
FULLEST	F UH L AH S T
FULLY	F UH L IY
FUN	F AH N
FURNISH	F ER N IH SH
FURNISHED	F ER N IH SH T
FURNITURE	F ER N IH CH ER
FURTHER	F ER DH ER
FUSS	F AH S
FUTURE	F Y UW CH ER
G	JH IY
GAIETIES	G EY AH T IY Z
GAIETY	G EY AH T IY
GAILY	G EY L IY
GAIN	G EY N
GAINED	G EY N D
GAINING	G EY N IH NG
GALLANT	G AE L AH N T
GALLANTRY	G AE L AH N T R IY
GALLERY	G AE L ER IY
GAME	G EY M
GAMESTER	G EY M S T ER
GAMING	G EY M IH NG
GAPED	G EY P T
GARDEN	G AA R D AH N
GARDENER	G AA R D AH N ER
GARDENER'S	G AA R D AH N ER Z
GARDINER	G AA R D N ER
GARDINER'S	G AA R D N ER Z
GARDINERS	G AA R D I N ER S
GATE	G EY T
GATES	G EY T S
GATHERED	G AE DH ER D
GATHERING	G AE DH ER IH NG
GAUDY	G AO D IY
GAVE	G EY V
GAY	G EY
GAYER	G EY ER
GAZE	G EY Z
GENERAL	JH EH N ER AH L
GENERAL(2)	JH EH N R AH L
GENERAL'S	JH EH N ER AH L Z
GENERAL'S(2)	JH EH N R AH L Z
GENERALITY	JH EH N ER AE L AH T IY
GENERALLY	JH EH N ER AH L IY
GENERALLY(2)	JH EH N R AH L IY
GENERATION	JH EH N ER EY SH AH N
GENERATIONS	JH EH N ER EY SH AH N Z
GENEROUS	JH EH N ER AH S
GENEROUSLY	JH EH N ER AH S L IY
GENIUS	JH IY N Y AH S
GENTEEL	JH EH N T IY L
GENTLE	JH EH N T AH L
GENTLE(2)	JH EH N AH L
GENTLEMAN	JH EH N T AH L M AH N
GENTLEMAN(2)	JH EH N AH L M AH N
GENTLEMAN'S	JH EH N T AH L M AH N Z
GENTLEMAN'S(2)	JH EH N AH L M AH N Z
GENTLEMANLIKE	JH EH N T AH L M AE N L AY K
GENTLEMEN	JH EH N T AH L M IH N
GENTLEMEN(2)	JH EH N AH L M IH N
GENTLEMEN'S	JH EH N T AH L M EH N Z
GENTLEMEN'S(2)	JH EH N AH L M EH N Z
GENTLENESS	JH EH N T AH L N AH S
GENTLENESS(2)	JH EH N AH L N AH S
GENTLEST	JH EH N T AH L AH S T
GENTLEWOMAN	JH EH N T AH L W UH M AH N
GENTLEWOMAN(2)	JH EH N AH L W UH M AH N
GENUINE	JH EH N Y AH W AH N
GENUINE(2)	JH EH N Y UW W AY N
GET	G EH T
GET(2)	G IH T
GETS	G EH T S
GETS(2)	G IH T S
GETTING	G EH T IH NG
GETTING(2)	G IH T IH NG
GIDDINESS	G I D I N EH S
GIFT	G IH F T
GIG	G IH G
GIRL	G ER L
GIRLS	G ER L Z
GIVE	G IH V
GIVEN	G IH V AH N
GIVEN(2)	G IH V IH N
GIVES	G IH V Z
GIVING	G IH V IH NG
GLAD	G L AE D
GLADLY	G L AE D L IY
GLANCE	G L AE N S
GLANCING	G L AE N S IH NG
GLASS	G L AE S
GLAZING	G L EY Z IH NG
GLEN	G L EH N
GLIMPSE	G L IH M P S
GLOOM	G L UW M
GLOOMY	G L UW M IY
GLORIED	G L OW R IY D
GLORIES	G L AO R IY Z
GLORY	G L AO R IY
GLOVE	G L AH V
GLOW	G L OW
GLOWING	G L OW IH NG
GO	G OW
GOD	G AA D
GOD'S	G AA D Z
GODFATHER	G AA D F AA DH ER
GODSON	G AO D S axn
GOES	G OW Z
GOING	G OW IH NG
GOING(2)	G OW IH N
GONE	G AO N
GOOD	G UH D
GOOD(2)	G IH D
GOODNESS	G UH D N AH S
GOODNESS(2)	G UH D N IH S
GOODWILL	G UH D W IH L
GOSSIPING	G AA S AH P IH NG
GOT	G AA T
GOULDING	G UW L D IH NG
GOULDINGS	G OW L D I ng Z
GOVERNED	G AH V ER N D
GOVERNESS	G AH V ER N AH S
GOWN	G AW N
GOWNS	G AW N Z
GRACE	G R EY S
GRACECHURCH	G R EY S CH ER CH
GRACEFUL	G R EY S F AH L
GRACEFULLY	G R EY S F AH L IY
GRACES	G R EY S IH Z
GRACIOUS	G R EY SH AH S
GRACIOUSLY	G R EY SH AH S L IY
GRACIOUSNESS	G R EY SH AH S N AH S
GRADUAL	G R AE JH UW AH L
GRADUALLY	G R AE JH UW AH L IY
GRADUALLY(2)	G R AE JH UW L IY
GRAIN	G R EY N
GRAND	G R AE N D
GRANDEUR	G R AE N D UW R
GRANDFATHER'S	G R AE N D F AA DH ER Z
GRANDFATHER'S(2)	G R AE N F AA DH ER Z
GRANTLEY'S	G R AE N T L II S
GRAPES	G R EY P S
GRASP	G R AE S P
GRATEFUL	G R EY T F AH L
GRATEFULLY	G R EY T F AH L IY
GRATIFICATION	G R AE T AH F AH K EY SH AH N
GRATIFIED	G R AE T AH F AY D
GRATIFY	G R AE T AH F AY
GRATIFYING	G R AE T AH F AY IH NG
GRATITUDE	G R AE T AH T UW D
GRATULATION	G R AE T U L EY SH axn
GRAVE	G R EY V
GRAVEL	G R AE V AH L
GRAVELY	G R EY V L IY
GRAVITY	G R AE V AH T IY
GRAVITY(2)	G R AE V IH T IY
GREAT	G R EY T
GREATER	G R EY T ER
GREATEST	G R EY T AH S T
GREATLY	G R EY T L IY
GREATNESS	G R EY T N AH S
GREEN	G R IY N
GRETNA	G R EH T N AH
GREW	G R UW
GRIEF	G R IY F
GRIEFS	G R II F S
GRIEVANCES	G R IY V AH N S AH Z
GRIEVANCES(2)	G R IY V AH N S IH Z
GRIEVE	G R IY V
GRIEVED	G R IY V D
GRIEVING	G R IY V IH NG
GRIEVOUS	G R IY V AH S
GRIEVOUSLY	G R IY V AH S L IY
GROSS	G R OW S
GROSSEST	G R OW S EH S T
GROSVENOR	G R OW V N ER
GROUND	G R AW N D
GROUNDS	G R AW N D Z
GROUNDS(2)	G R AW N Z
GROUNDWORK	G R AW N D W ER K
GROUP	G R UW P
GROUPED	G R UW P T
GROVE	G R OW V
GROW	G R OW
GROWING	G R OW IH NG
GROWN	G R OW N
GROWTH	G R OW TH
GUARD	G AA R D
GUARDED	G AA R D AH D
GUARDED(2)	G AA R D IH D
GUARDIAN	G AA R D IY AH N
GUARDIANS	G AA R D IY AH N Z
GUARDIANSHIP	G AA R D IY AH N SH IH P
GUESS	G EH S
GUESSED	G EH S T
GUEST	G EH S T
GUESTS	G EH S T S
GUESTS(2)	G EH S S
GUESTS(3)	G EH S
GUIDANCE	G AY D AH N S
GUIDE	G AY D
GUIDED	G AY D AH D
GUIDED(2)	G AY D IH D
GUIDING	G AY D IH NG
GUILT	G IH L T
GUILTY	G IH L T IY
GUINEA	G IH N IY
GULF	G AH L F
HABIT	HH AE B AH T
HABITS	HH AE B AH T S
HABITUAL	HH AH B IH CH UW AH L
HACK	HH AE K
HACKNEY	HH AE K N IY
HACKNEYED	HH AE K N IY D
HAD	HH AE D
HAGGERSTON	HH AE G ER S T axn
HAIR	HH EH R
HALF	HH AE F
HALL	HH AO L
HAM	HH AE M
HAND	HH AE N D
HANDED	HH AE N D AH D
HANDED(2)	HH AE N D IH D
HANDKERCHIEF	HH AE NG K ER CH IH F
HANDKERCHIEF(2)	HH AE NG K ER CH IY F
HANDS	HH AE N D Z
HANDS(2)	HH AE N Z
HANDSOME	HH AE N S AH M
HANDSOMELY	HH AE N S AH M L IY
HANDSOMER	HH AE N S AH M ER
HANDSOMEST	HH AE N S AH M AH S T
HANDWRITING	HH AE N D R AY T IH NG
HANG	HH AE NG
HANGING	HH AE NG IH NG
HANGING(2)	HH AE NG G IH NG
HAPPEN	HH AE P AH N
HAPPENED	HH AE P AH N D
HAPPENING	HH AE P AH N IH NG
HAPPENING(2)	HH AE P N IH NG
HAPPENS	HH AE P AH N Z
HAPPIER	HH AE P IY ER
HAPPIEST	HH AE P IY AH S T
HAPPILY	HH AE P AH L IY
HAPPINESS	HH AE P IY N AH S
HAPPY	HH AE P IY
HARBOURED	HH AA R B OW Y AH R D
HARD	HH AA R D
HARDENED	HH AA R D AH N D
HARDEST	HH AA R D AH S T
HARDLY	HH AA R D L IY
HARDSHIP	HH AA R D SH IH P
HARDSHIPS	HH AA R D SH IH P S
HARM	HH AA R M
HARMONY	HH AA R M AH N IY
HARP	HH AA R P
HARRIET	HH EH R IY AH T
HARRINGTONS	HH AE R I ng T axn S
HARSHLY	HH AA R SH L IY
HAS	HH AE Z
HAS(2)	HH AH Z
HASTE	HH EY S T
HASTEN	HH EY S AH N
HASTENED	HH EY S AH N D
HASTENING	HH EY S AH N IH NG
HASTENING(2)	HH EY S N IH NG
HASTILY	HH EY S T AH L IY
HASTY	HH EY S T IY
HAT	HH AE T
HATE	HH EY T
HATED	HH EY T AH D
HATED(2)	HH EY T IH D
HATEFULLY	HH EY T F U L II
HATES	HH EY T S
HATFIELD	HH AE T F IY L D
HATING	HH EY T IH NG
HATRED	HH EY T R AH D
HAUGHTY	HH AO T IY
HAUNCH	HH AW N CH
HAUNT	HH AO N T
HAUTEUR	HH AO T AH R
HAVE	HH AE V
HAVING	HH AE V IH NG
HAYE	HH EY
HAZARDED	HH AE Z ER D IH D
HE	HH IY
HEAD	HH EH D
HEADACHE	HH EH D EY K
HEADED	HH EH D AH D
HEADED(2)	HH EH D IH D
HEADQUARTERS	HH EH D K W AO R T ER Z
HEADQUARTERS(2)	HH EH D K AO R T ER Z
HEADS	HH EH D Z
HEADSTRONG	HH EH D S T R AO NG
HEAL	HH IY L
HEALTH	HH EH L TH
HEALTHFUL	HH EH L TH F AH L
HEALTHFULNESS	HH EH L TH F U L N EH S
HEALTHY	HH EH L TH IY
HEAR	HH IY R
HEARD	HH ER D
HEARERS	HH IY R ER Z
HEARING	HH IY R IH NG
HEARS	HH IY R Z
HEART	HH AA R T
HEARTED	HH AA R T AH D
HEARTED(2)	HH AA R T IH D
HEARTEDNESS	HH AA R T AH D N AH S
HEARTENING	HH AA R T AH N IH NG
HEARTENING(2)	HH AA R T N IH NG
HEARTFELT	HH AA R T F EH L T
HEARTH	HH AA R TH
HEARTILY	HH AA R T AH L IY
HEARTY	HH AA R T IY
HEAVEN	HH EH V AH N
HEAVEN'S	HH EH V AH N Z
HEAVENS	HH EH V AH N Z
HEAVIER	HH EH V IY ER
HEAVY	HH EH V IY
HEDGE	HH EH JH
HEEDLESS	HH II D L EH S
HEIGHT	HH AY T
HEIGHTEN	HH AY T AH N
HEIGHTENED	HH AY T AH N D
HEINOUS	HH EY N AH S
HEIRESS	EH R AH S
HEIRS	EH R Z
HELD	HH EH L D
HELP	HH EH L P
HENCE	HH EH N S
HENCEFORTH	HH EH N S F AO R TH
HER	HH ER
HERE	HH IY R
HERE'S	HH IH R Z
HEREABOUTS	HH IH R AH B AW T S
HEREAFTER	HH IH R AE F T ER
HERETOFORE	HH IH R T AH F AO R
HERMITAGE	HH ER M AH T AH JH
HERS	HH ER Z
HERSELF	HH ER S EH L F
HERTFORDSHIRE	HH ER T F OW R D SH AY ER
HESITATE	HH EH Z AH T EY T
HESITATED	HH EH Z IH T EY T IH D
HESITATING	HH EH Z AH T EY T IH NG
HESITATION	HH EH Z AH T EY SH AH N
HIDE	HH AY D
HIGH	HH AY
HIGHER	HH AY ER
HIGHEST	HH AY AH S T
HIGHFLOWN	HH AY F L OW N
HIGHLY	HH AY L IY
HILL	HH IH L
HILLS	HH IH L Z
HIM	HH IH M
HIM(2)	IH M
HIMSELF	HH IH M S EH L F
HINT	HH IH N T
HINTED	HH IH N T AH D
HINTED(2)	HH IH N T IH D
HINTED(3)	HH IH N IH D
HINTS	HH IH N T S
HIRE	HH AY ER
HIRE(2)	HH AY R
HIRED	HH AY ER D
HIS	HH IH Z
HISTORIES	HH IH S T ER IY Z
HISTORIES(2)	HH IH S T R IY Z
HISTORY	HH IH S T ER IY
HISTORY(2)	HH IH S T R IY
HITHER	HH IH DH ER
HITHERTO	HH IH DH ER T UW
HOLD	HH OW L D
HOLDING	HH OW L D IH NG
HOME	HH OW M
HONEST	AA N AH S T
HONESTLY	AA N AH S T L IY
HONESTLY(2)	AA N AH S L IY
HONOUR	AA N ER
HONOURABLE	AA N ER AH B AH L
HONOURED	AA N ER D
HONOURS	AA N ER Z
HOPE	HH OW P
HOPED	HH OW P T
HOPELESS	HH OW P L AH S
HOPES	HH OW P S
HOPING	HH OW P IH NG
HORRIBLE	HH AO R AH B AH L
HORRID	HH AO R AH D
HORROR	HH AO R ER
HORSE	HH AO R S
HORSEBACK	HH AO R S B AE K
HORSES	HH AO R S AH Z
HORSES(2)	HH AO R S IH Z
HORSEWOMAN	HH AO R S W UH M AH N
HOSPITALITY	HH AA S P AH T AE L AH T IY
HOT	HH AA T
HOTEL	HH OW T EH L
HOTELS	HH OW T EH L Z
HOUR	AW ER
HOUR(2)	AW R
HOUR'S	AW ER Z
HOURS	AW ER Z
HOURS(2)	AW R Z
HOUSE	HH AW S
HOUSEHOLD	HH AW S HH OW L D
HOUSEKEEPER	HH AW S K IY P ER
HOUSEKEEPER'S	HH AW S K IY P ER Z
HOUSEKEEPING	HH AW S K IY P IH NG
HOUSEMAID	HH AW S M EY D
HOUSEMAIDS	HH AW S M EY D Z
HOUSES	HH AW S AH Z
HOUSES(2)	HH AW S IH Z
HOW	HH AW
HOWEVER	HH AW EH V ER
HOWSOEVER	HH AW S OW EH V ER
HUG	HH AH G
HUMAN	HH Y UW M AH N
HUMAN(2)	Y UW M AH N
HUMANITY	HH Y UW M AE N IH T IY
HUMANITY(2)	Y UW M AE N IH T IY
HUMBLE	HH AH M B AH L
HUMBLED	HH AH M B AH L D
HUMBLING	HH AH M B AH L IH NG
HUMBLING(2)	HH AH M B L IH NG
HUMILIATING	HH Y UW M IH L IY EY T IH NG
HUMILIATION	HH Y UW M IH L IY EY SH AH N
HUMILITY	HH Y UW M IH L IH T IY
HUMOUR	HH Y UW M ER
HUMOURED	HH Y UW M ER D
HUNDRED	HH AH N D R AH D
HUNDRED(2)	HH AH N D R IH D
HUNDRED(3)	HH AH N ER D
HUNDRED(4)	HH AH N D ER D
HUNSFORD	HH axn S F OW R D
HUNTING	HH AH N T IH NG
HURRIED	HH ER IY D
HURRY	HH ER IY
HURRYING	HH ER IY IH NG
HURST	HH ER S T
HURST'S	HH ER S T S
HURSTS	HH ER S TS
HURT	HH ER T
HURTS	HH ER T S
HUSBAND	HH AH Z B AH N D
HUSBAND'S	HH AH Z B AH N D Z
HUSBANDS	HH AH Z B AH N D Z
HUSHED	HH AH SH T
HYPOCRISY	HH IH P AA K R AH S IY
HYPOCRITICAL	HH IH P AH K R IH T IH K AH L
HYSTERICS	HH IH S T EH R IH K S
I	AY
IDEA	AY D IY AH
IDEAS	AY D IY AH Z
IDLE	AY D AH L
IDLENESS	AY D AH L N AH S
IF	IH F
IGNORANCE	IH G N ER AH N S
IGNORANT	IH G N ER AH N T
ILL	IH L
ILLIBERAL	IH L IH B ER AH L
ILLITERATE	IH L IH T ER AH T
ILLNESS	IH L N AH S
ILLUSTRATION	IH L AH S T R EY SH AH N
ILLUSTRIOUS	IH L AH S T R IY AH S
IMAGINABLE	IH M AE JH AH N AH B AH L
IMAGINARY	IH M AE JH AH N EH R IY
IMAGINATION	IH M AE JH AH N EY SH AH N
IMAGINATIONS	IH M AE JH AH N EY SH AH N Z
IMAGINE	IH M AE JH AH N
IMAGINED	IH M AE JH AH N D
IMITATE	IH M AH T EY T
IMITATED	IH M AH T EY T IH D
IMITATION	IH M AH T EY SH AH N
IMITATIONS	IH M IH T EY SH AH N Z
IMMEDIATE	IH M IY D IY AH T
IMMEDIATELY	IH M IY D IY AH T L IY
IMMORAL	IH M AO R AH L
IMMOVABLE	IH M UW V AH B AH L
IMPARTED	IH M P AA R T IH D
IMPARTIAL	IH M P AA R SH AH L
IMPARTIALITY	IH M P AA R SH IY AE L IH T IY
IMPASSABLE	IH M P AE S AH B AH L
IMPATIENCE	IH M P EY SH AH N S
IMPATIENT	IH M P EY SH AH N T
IMPATIENTLY	IH M P EY SH AH N T L IY
IMPELLED	IH M P EH L D
IMPENETRABLY	I M P EH N EH T R AX B L II
IMPERFECTION	IH M P ER F EH K SH AH N
IMPERFECTLY	IH M P ER F IH K T L IY
IMPERTINENCE	IH M P ER T AH N AH N S
IMPERTINENT	IH M P ER T AH N AH N T
IMPERTURBABLY	I M P ER T ER B AX B L II
IMPETUOUS	IH M P EH CH W AH S
IMPLACABILITY	I M P L AE K AX B I L I T II
IMPLACABLE	IH M P L AE K AH B AH L
IMPLICIT	IH M P L IH S AH T
IMPLICITNESS	I M P L I S I T N EH S
IMPLIED	IH M P L AY D
IMPLIES	IH M P L AY Z
IMPLY	IH M P L AY
IMPOLITIC	IH M P AO L IH T IH K
IMPORTANCE	IH M P AO R T AH N S
IMPORTANT	IH M P AO R T AH N T
IMPORTING	IH M P AO R T IH NG
IMPORTUNE	I M P AO R CH Y OO N
IMPORTUNED	I M P AO R CH Y OO N D
IMPOSE	IH M P OW Z
IMPOSED	IH M P OW Z D
IMPOSING	IH M P OW Z IH NG
IMPOSSIBLE	IH M P AA S AH B AH L
IMPRESSED	IH M P R EH S T
IMPRESSING	IH M P R EH S IH NG
IMPRESSION	IH M P R EH SH AH N
IMPRESSIVE	IH M P R EH S IH V
IMPROBABLE	IH M P R AA B AH B AH L
IMPROPER	IH M P R AA P ER
IMPROPRIETIES	IH M P R AH P R AY AH T IY Z
IMPROPRIETY	IH M P R AH P R AY AH T IY
IMPROVE	IH M P R UW V
IMPROVED	IH M P R UW V D
IMPROVEMENT	IH M P R UW V M AH N T
IMPROVEMENTS	IH M P R UW V M AH N T S
IMPROVES	IH M P R UW V Z
IMPRUDENCE	IH M P R UW D AH N S
IMPRUDENT	IH M P R UW D AH N T
IMPUDENCE	IH M P Y AH D AH N S
IMPUDENT	IH M P Y AH D AH N T
IMPULSE	IH M P AH L S
IMPULSES	IH M P AH L S IH Z
IMPUNITY	IH M P Y UW N IH T IY
IMPURITIES	IH M P Y UH R AH T IY Z
IMPUTE	IH M P Y UW T
IMPUTED	IH M P Y UW T IH D
IMPUTING	I M P Y OO T I ng
IN	IH N
INADEQUATE	IH N AE D AH K W AH T
INADEQUATE(2)	IH N AE D AH K W EY T
INATTENTION	IH N AH T EH N CH AH N
INATTENTIVE	IH N AH T EH N T IH V
INCAPABLE	IH N K EY P AH B AH L
INCAUTIOUSLY	I ng K AO SH AX S L II
INCENSED	IH N S EH N S T
INCESSANT	IH N S EH S AH N T
INCESSANTLY	IH N S EH S AH N T L IY
INCHES	IH N CH AH Z
INCHES(2)	IH N CH IH Z
INCIVILITY	IH N S IH V IH L IH T IY
INCLINATION	IH N K L AH N EY SH AH N
INCLINATIONS	IH N K L AH N EY SH AH N Z
INCLINED	IH N K L AY N D
INCLUDE	IH N K L UW D
INCLUDED	IH N K L UW D AH D
INCLUDED(2)	IH N K L UW D IH D
INCLUDING	IH N K L UW D IH NG
INCOME	IH N K AH M
INCOMPREHENSIBLE	IH NG K AA M P R AH HH EH N S IH B AH L
INCONCEIVABLE	IH N K AH N S IY V AH B AH L
INCONSIDERABLE	IH N K AH N S IH D ER AH B AH L
INCONSISTENCIES	IH NG K AA N S IH S T EH N S IY Z
INCONSISTENCY	IH N K AH N S IH S T AH N S IY
INCONVENIENCE	IH N K AH N V IY N Y AH N S
INCONVENIENCES	IH N K AH N V IY N Y AH N S IH Z
INCONVENIENT	IH N K AH N V IY N Y AH N T
INCREASE	IH N K R IY S
INCREASED	IH N K R IY S T
INCREASES	IH N K R IY S AH Z
INCREASES(2)	IH N K R IY S IH Z
INCREASING	IH N K R IY S IH NG
INCREDIBLE	IH N K R EH D AH B AH L
INCREDULITY	IH N K R AH D UW L IH T IY
INCREDULOUS	IH N K R EH JH AH L AH S
INCUMBENT	IH N K AH M B AH N T
INCUR	IH N K ER
INCURRED	IH N K ER D
INDEBTED	IH N D EH T AH D
INDEBTED(2)	IH N D EH T IH D
INDECISION	IH N D IH S IH ZH AH N
INDECORUM	I N D EH K OW R AX M
INDEED	IH N D IY D
INDEFINITE	IH N D EH F AH N AH T
INDELICACY	IH N D EH L IH K AH S IY
INDELICATE	IH N D EH L IH K AH T
INDEPENDENCE	IH N D IH P EH N D AH N S
INDEPENDENT	IH N D IH P EH N D AH N T
INDICATED	IH N D AH K EY T AH D
INDICATED(2)	IH N D AH K EY T IH D
INDIFFERENCE	IH N D IH F ER AH N S
INDIFFERENCE(2)	IH N D IH F R AH N S
INDIFFERENT	IH N D IH F R AH N T
INDIFFERENT(2)	IH N D IH F ER AH N T
INDIGNANT	IH N D IH G N AH N T
INDIGNATION	IH N D IH G N EY SH AH N
INDIGNITY	IH N D IH G N AH T IY
INDIRECT	IH N D ER EH K T
INDISCREET	IH N D IH S K R IY T
INDISPENSABLY	IH N D IH S P EH N S AH B AH L IY
INDISPOSED	IH N D IH S P OW Z D
INDISTINCTLY	I N D I S T I ng K T L II
INDIVIDUAL	IH N D AH V IH JH AH W AH L
INDIVIDUALLY	IH N D IH V IH JH UW AH L IY
INDIVIDUALLY(2)	IH N D IH V IH JH AH L IY
INDOLENCE	IH N D AH L AH N S
INDOLENT	IH N D AH L AH N T
INDUCE	IH N D UW S
INDUCED	IH N D UW S T
INDUCEMENT	IH N D UW S M AH N T
INDUCEMENTS	IH N D UW S M AH N T S
INDULGE	IH N D AH L JH
INDULGED	IH N D AH L JH D
INDULGENCE	IH N D AH L JH AH N S
INDULGENT	IH N D AH L JH AH N T
INDULGING	IH N D AH L JH IH NG
INDUSTRIOUSLY	IH N D AH S T R IY AH S L IY
INEFFECTUAL	IH N AH F EH K CH UW AH L
INEVITABLE	IH N EH V AH T AH B AH L
INEVITABLY	IH N EH V AH T AH B L IY
INEXHAUSTIBLE	IH N IH G Z AO S T AH B AH L
INEXPRESSIBLE	IH N IH K S P R EH S AH B AH L
INEXPRESSIBLY	IH N IH K S P R EH S AH B L IY
INFAMOUS	IH N F AH M AH S
INFAMY	IH N F AH M IY
INFANCY	IH N F AH N S IY
INFATUATION	IH N F AE CH UW EY SH AH N
INFERENCES	IH N F ER EH N S IH Z
INFERIOR	IH N F IH R IY ER
INFERIORITY	IH N F IH R IY AO R IH T IY
INFINITE	IH N F AH N AH T
INFINITELY	IH N F AH N AH T L IY
INFLEXIBLY	I N F L EH K S I B L II
INFLICT	IH N F L IH K T
INFLICTED	IH N F L IH K T IH D
INFLICTION	IH N F L IH K SH AH N
INFLUENCE	IH N F L UW AH N S
INFLUENCED	IH N F L UW AH N S T
INFLUENCING	IH N F L UW AH N S IH NG
INFORM	IH N F AO R M
INFORMALITY	IH N F ER M AE L IH T IY
INFORMATION	IH N F ER M EY SH AH N
INFORMATION(2)	IH N F AO R M EY SH AH N
INFORMED	IH N F AO R M D
INFORMING	IH N F AO R M IH NG
INFORMS	IH N F AO R M Z
INGENIOUS	IH N JH IY N Y AH S
INGENUITY	IH N JH AH N UW AH T IY
INGRATITUDE	IH N G R AE T AH T UW D
INHABITANTS	IH N HH AE B AH T AH N T S
INHABITANTS(2)	IH N HH AE B IH T AH N T S
INHERIT	IH N HH EH R AH T
INHERITED	IH N HH EH R AH T IH D
INHERITING	IH N HH EH R AH T IH NG
INHUMANITY	IH N HH Y UW M AE N AH T IY
INIQUITOUS	I N I K W I T AX S
INJUNCTION	IH N JH AH NG K SH AH N
INJUNCTION(2)	IH N JH AH NG SH AH N
INJUNCTIONS	IH N JH AH NG K SH AH N Z
INJUNCTIONS(2)	IH N JH AH NG SH AH N Z
INJURE	IH N JH ER
INJURED	IH N JH ER D
INJURIES	IH N JH ER IY Z
INJURING	IH N JH ER IH NG
INJURIOUS	IH N JH UH R IY AH S
INJURY	IH N JH ER IY
INJUSTICE	IH N JH AH S T IH S
INMATE	IH N M EY T
INMATES	IH N M EY T S
INN	IH N
INNOCENCE	IH N AH S AH N S
INNOCENT	IH N AH S AH N T
INNOCENTLY	IH N AH S AH N T L IY
INNS	IH N Z
INOFFENSIVE	IH N AH F EH N S IH V
INQUIRE	IH N K W AY R
INQUIRED	IH N K W AY ER D
INQUIRIES	IH N K W AY ER IY Z
INQUIRIES(2)	IH N K W ER IY Z
INQUIRING	IH N K W AY ER IH NG
INQUIRY	IH N K W AY R IY
INQUIRY(2)	IH N K W ER R IY
INSENSIBILITY	IH N S EH N S AH B IH L AH T IY
INSENSIBLE	IH N S EH N S AH B AH L
INSIGNIFICANCE	IH N S IH G N Y IH F IH K AH N S
INSIGNIFICANT	IH N S IH G N Y IH F IH K AH N T
INSINCERE	IH N S IH N S IH R
INSINUATING	IH N S IH N Y UW EY T IH NG
INSIPID	IH N S IH P AH D
INSIPIDITY	IH N S IH P AH D AH T IY
INSIST	IH N S IH S T
INSISTED	IH N S IH S T AH D
INSISTED(2)	IH N S IH S T IH D
INSISTS	IH N S IH S T S
INSISTS(2)	IH N S IH S S
INSISTS(3)	IH N S IH S
INSOLENCE	IH N S AH L AH N S
INSOLENT	IH N S AH L AH N T
INSPECTION	IH N S P EH K SH AH N
INSPIRE	IH N S P AY R
INSPIRED	IH N S P AY ER D
INSPIRES	IH N S P AY R Z
INSPIRING	IH N S P AY R IH NG
INSPIRING(2)	IH N S P AY ER IH NG
INSTABILITY	IH N S T AH B IH L IH T IY
INSTANCE	IH N S T AH N S
INSTANCES	IH N S T AH N S AH Z
INSTANCES(2)	IH N S T AH N S IH Z
INSTANT	IH N S T AH N T
INSTANTANEOUS	IH N S T AH N T AE N IY AH S
INSTANTLY	IH N S T AH N T L IY
INSTEAD	IH N S T EH D
INSTINCTIVELY	IH N S T IH NG K T IH V L IY
INSTITUTED	IH N S T AH T UW T AH D
INSTRUCT	IH N S T R AH K T
INSTRUCTED	IH N S T R AH K T AH D
INSTRUCTED(2)	IH N S T R AH K T IH D
INSTRUCTING	IH N S T R AH K T IH NG
INSTRUCTION	IH N S T R AH K SH AH N
INSTRUCTIONS	IH N S T R AH K SH AH N Z
INSTRUMENT	IH N S T R AH M AH N T
INSUFFERABLE	IH N S AH F ER AH B AH L
INSUFFERABLY	IH N S AH F ER AH B L IY
INSUFFICIENT	IH N S AH F IH SH AH N T
INSULTED	IH N S AH L T IH D
INSULTING	IH N S AH L T IH NG
INSUPPORTABLE	IH N S AH P AO R T AH B AH L
INTEGRITY	IH N T EH G R AH T IY
INTEGRITY(2)	IH N T EH G R IH T IY
INTELLIGENCE	IH N T EH L AH JH AH N S
INTELLIGENT	IH N T EH L AH JH AH N T
INTELLIGIBLE	IH N T EH L AH JH AH B AH L
INTEND	IH N T EH N D
INTENDED	IH N T EH N D AH D
INTENDED(2)	IH N T EH N D IH D
INTENDING	IH N T EH N D IH NG
INTENTION	IH N T EH N CH AH N
INTENTIONALLY	IH N T EH N SH AH N AH L IY
INTENTIONS	IH N T EH N CH AH N Z
INTENTLY	IH N T EH N T L IY
INTERCOURSE	IH N T ER K AO R S
INTERCOURSE(2)	IH N ER K AO R S
INTEREST	IH N T R AH S T
INTEREST(2)	IH N T R IH S T
INTEREST(3)	IH N T ER AH S T
INTEREST(4)	IH N T ER IH S T
INTERESTED	IH N T R AH S T AH D
INTERESTED(2)	IH N T R IH S T IH D
INTERESTED(3)	IH N T ER AH S T AH D
INTERESTED(4)	IH N T ER IH S T IH D
INTERESTING	IH N T R AH S T IH NG
INTERESTING(2)	IH N T R IH S T IH NG
INTERESTING(3)	IH N T ER AH S T IH NG
INTERESTING(4)	IH N T ER IH S T IH NG
INTERFERE	IH N T ER F IH R
INTERFERE(2)	IH N ER F IH R
INTERFERENCE	IH N T ER F IH R AH N S
INTERFERENCE(2)	IH N ER F IH R AH N S
INTERFERING	IH N T ER F IH R IH NG
INTERFERING(2)	IH N ER F IH R IH NG
INTERMARRIAGE	IH N T ER M EH R IH JH
INTERMEDIATE	IH N T ER M IY D IY IH T
INTERMEDIATE(2)	IH N ER M IY D IY IH T
INTERMISSION	IH N T ER M IH SH AH N
INTERPOSE	IH N T ER P OW Z
INTERPRETATION	IH N T ER P R IH T EY SH AH N
INTERRUPT	IH N T ER AH P T
INTERRUPT(2)	IH N ER AH P T
INTERRUPTED	IH N T ER AH P T IH D
INTERRUPTED(2)	IH N ER AH P T IH D
INTERRUPTING	IH N T ER AH P T IH NG
INTERRUPTING(2)	IH N ER AH P T IH NG
INTERRUPTION	IH N T ER AH P SH AH N
INTERRUPTION(2)	IH N ER AH P SH AH N
INTERRUPTIONS	IH N T ER AH P SH AH N Z
INTERRUPTIONS(2)	IH N ER AH P SH AH N Z
INTERVAL	IH N T ER V AH L
INTERVAL(2)	IH N ER V AH L
INTERVALS	IH N T ER V AH L Z
INTERVALS(2)	IH N ER V AH L Z
INTERVENE	IH N T ER V IY N
INTERVENE(2)	IH N ER V IY N
INTERVIEW	IH N T ER V Y UW
INTERVIEW(2)	IH N ER V Y UW
INTIMACY	IH N T AH M AH S IY
INTIMATE	IH N T AH M AH T
INTIMATE(2)	IH N T AH M EY T
INTIMATE(3)	IH N AH M AH T
INTIMATELY	IH N T AH M AH T L IY
INTIMATES	IH N T AH M AH T S
INTIMATION	IH N T AH M EY SH AH N
INTIMIDATE	IH N T IH M IH D EY T
INTIMIDATED	IH N T IH M IH D EY T IH D
INTO	IH N T UW
INTO(2)	IH N T AH
INTOLERABLE	IH N T AA L ER AH B AH L
INTREPIDITY	I N T R EH P I D L II
INTRICATE	IH N T R AH K AH T
INTRIGUES	IH N T R IY G Z
INTRODUCE	IH N T R AH D UW S
INTRODUCE(2)	IH N T R OW D UW S
INTRODUCED	IH N T R AH D UW S T
INTRODUCED(2)	IH N T R OW D UW S T
INTRODUCING	IH N T R AH D UW S IH NG
INTRODUCING(2)	IH N T R OW D UW S IH NG
INTRODUCTION	IH N T R AH D AH K SH AH N
INTRODUCTION(2)	IH N T R OW D AH K SH AH N
INTRUDE	IH N T R UW D
INTRUDER	IH N T R UW D ER
INTRUDING	IH N T R UW D IH NG
INTRUSION	IH N T R UW ZH AH N
INURED	IH N Y UH R D
INVALID	IH N V AH L AH D
INVALID(2)	IH N V AH L IH D
INVALID(3)	IH N V AE L AH D
INVALUABLE	IH N V AE L Y AH B AH L
INVARIABLE	IH N V EH R IY AH B AH L
INVARIABLY	IH N V EH R IY AH B L IY
INVECTIVES	I N V EH K T I V Z
INVENT	IH N V EH N T
INVENTING	IH N V EH N T IH NG
INVENTION	IH N V EH N SH AH N
INVESTIGATION	IH N V EH S T AH G EY SH AH N
INVITATION	IH N V IH T EY SH AH N
INVITATIONS	IH N V IH T EY SH AH N Z
INVITE	IH N V AY T
INVITED	IH N V AY T AH D
INVITED(2)	IH N V AY T IH D
INVITING	IH N V AY T IH NG
INVOLUNTARILY	IH N V OW L AH N T ER IH L IY
INVOLUNTARILY(2)	IH N V AA L AH N T ER AH L IY
INVOLUNTARY	IH N V AA L AH N T EH R IY
INVOLVE	IH N V AA L V
INVOLVED	IH N V AA L V D
INVOLVES	IH N V AA L V Z
INVOLVING	IH N V AA L V IH NG
IRISH	AY R IH SH
IRKSOME	ER K S AH M
IRREGULARITY	IH R EH G Y AH L EH R AH T IY
IRRELIGIOUS	I R I L I JH AX S
IRREMEDIABLE	IH R IH M IY D IY AH B AH L
IRREPROACHABLE	IH R IH P R OW CH AH B AH L
IRRETRIEVABLE	I R I T R II V AX B AX L
IRREVOCABLY	IH R EH V AH K AH B L IY
IRREVOCABLY(2)	IH R EH V OW K AH B L IY
IRRITABLE	IH R AH T AH B AH L
IRRITATED	IH R AH T EY T AH D
IRRITATION	IH R IH T EY SH AH N
IS	IH Z
IT	IH T
ITALIAN	IH T AE L Y AH N
ITS	IH T S
ITSELF	IH T S EH L F
JAMES'S	JH EY M Z IH Z
JANE	JH EY N
JANE'S	JH EY N Z
JANUARY	JH AE N Y UW EH R IY
JEALOUS	JH EH L AH S
JEALOUSY	JH EH L AH S IY
JENKINSON	JH EH NG K IH N S AH N
JENKINSON'S	JH EH ng K I N S axn S
JESTINGLY	JH EH S I ng L II
JEWEL	JH UW AH L
JEWEL(2)	JH UW L
JEWELS	JH UW AH L Z
JEWELS(2)	JH UW L Z
JILT	JH IH L T
JOHN	JH AA N
JOIN	JH OY N
JOINED	JH OY N D
JOINING	JH OY N IH NG
JOINTS	JH OY N T S
JOKE	JH OW K
JOKES	JH OW K S
JOKING	JH OW K IH NG
JONES	JH OW N Z
JONES'S	JH OW N Z IH Z
JOT	JH AA T
JOURNEY	JH ER N IY
JOURNEYS	JH ER N IY Z
JOY	JH OY
JOYFUL	JH OY F AH L
JOYFULLY	JH OY F AH L IY
JUDGE	JH AH JH
JUDGED	JH AH JH D
JUDGEMENT	JH AH JH M AH N T
JUDGING	JH AH JH IH NG
JUDGMENT	JH AH JH M AH N T
JULY	JH UW L AY
JULY(2)	JH AH L AY
JUMBLED	JH AH M B AH L D
JUMPED	JH AH M P T
JUMPING	JH AH M P IH NG
JUMPS	JH AH M P S
JUNE	JH UW N
JUNIOR	JH UW N Y ER
JUST	JH AH S T
JUST(2)	JH IH S T
JUSTICE	JH AH S T AH S
JUSTICE(2)	JH AH S T IH S
JUSTIFICATION	JH AH S T AH F AH K EY SH AH N
JUSTIFIED	JH AH S T AH F AY D
JUSTIFY	JH AH S T AH F AY
JUSTIFYING	JH AH S T AH F AY IH NG
JUSTLY	JH AH S T L IY
KEENER	K IY N ER
KEENEST	K IY N AH S T
KEEP	K IY P
KEEPING	K IY P IH NG
KEEPS	K IY P S
KENILWORTH	K EH N AH L W ER TH
KENT	K EH N T
KEPT	K EH P T
KEPT(2)	K AE P T
KILL	K IH L
KILLED	K IH L D
KIND	K AY N D
KINDER	K AY N D ER
KINDEST	K AY N D AH S T
KINDLED	K IH N D AH L D
KINDLY	K AY N D L IY
KINDNESS	K AY N D N AH S
KINDRED	K IH N D R IH D
KINDS	K AY N D Z
KINDS(2)	K AY N Z
KING	K IH NG
KINGDOM	K IH NG D AH M
KISS	K IH S
KISSED	K IH S T
KITCHEN	K IH CH AH N
KITTY	K IH T IY
KITTY'S	K I T II Z
KLETT	K L EH T
KNEES	N IY Z
KNEW	N UW
KNEW(2)	N Y UW
KNIGHTHOOD	N AY T HH UH D
KNOW	N OW
KNOWING	N OW IH NG
KNOWLEDGE	N AA L AH JH
KNOWLEDGE(2)	N AA L IH JH
KNOWN	N OW N
KNOWS	N OW Z
KYMPTON	K I M T axn
LA	L AA
LABOUR	L EY B AW R
LABOUR(2)	L EY B ER
LACE	L EY S
LACONIC	L AA K AA N IH K
LAD	L AE D
LADIES	L EY D IY Z
LADY	L EY D IY
LADY'S	L EY D IY Z
LADYSHIP	L EY D IY SH IH P
LADYSHIP'S	L EY D IY SH IH P S
LAGGED	L AE G D
LAID	L EY D
LAITY	L EY AH T IY
LAKES	L EY K S
LAMBTON	L AE M T axn
LAMENT	L AH M EH N T
LAMENTATIONS	L AE M AH N T EY SH AH N Z
LAMENTED	L AH M EH N T IH D
LAMENTING	L AH M EH N T IH NG
LAND	L AE N D
LANDING	L AE N D IH NG
LANDLORD	L AE N D L AO R D
LANE	L EY N
LANES	L EY N Z
LANGUAGE	L AE NG G W AH JH
LANGUAGE(2)	L AE NG G W IH JH
LANGUAGES	L AE NG G W AH JH AH Z
LANGUAGES(2)	L AE NG G W IH JH IH Z
LANGUOR	L AE N G W AH R
LARDER	L AA R D ER
LARGE	L AA R JH
LARGER	L AA R JH ER
LARGEST	L AA R JH AH S T
LAST	L AE S T
LAST(2)	L AO S T
LAST(3)	L AE S
LASTED	L AE S T AH D
LASTED(2)	L AE S T IH D
LASTING	L AE S T IH NG
LASTLY	L AE S T L IY
LATE	L EY T
LATELY	L EY T L IY
LATER	L EY T ER
LATEST	L EY T AH S T
LATTER	L AE T ER
LATTERLY	L AE T ER L IY
LAUDABLE	L AO D AH B AH L
LAUGH	L AE F
LAUGHED	L AE F T
LAUGHING	L AE F IH NG
LAUGHINGLY	L AE F IH NG L IY
LAUGHTER	L AE F T ER
LAUREL	L AO R AH L
LAW	L AO
LAW(2)	L AA
LAW'S	L AO Z
LAWFULLY	L AO F AH L IY
LAWN	L AO N
LAY	L EY
LAYING	L EY IH NG
LEAD	L EH D
LEAD(2)	L IY D
LEADING	L IY D IH NG
LEADS	L IY D Z
LEANING	L IY N IH NG
LEARN	L ER N
LEARNED	L ER N D
LEARNED(2)	L ER N IH D
LEARNING	L ER N IH NG
LEARNT	L ER N T
LEASE	L IY S
LEAST	L IY S T
LEAVE	L IY V
LEAVES	L IY V Z
LEAVING	L IY V IH NG
LED	L EH D
LEFT	L EH F T
LEGACY	L EH G AH S IY
LEGAL	L IY G AH L
LEGALLY	L IY G AH L IY
LEISURE	L EH ZH ER
LEISURE(2)	L IY ZH ER
LEISURELY	L IY Z ER L IY
LEND	L EH N D
LENGTH	L EH NG K TH
LENGTH(2)	L EH NG TH
LESS	L EH S
LESSEN	L EH S AH N
LESSENED	L EH S AH N D
LESSENING	L EH S AH N IH NG
LESSON	L EH S AH N
LEST	L EH S T
LET	L EH T
LETTER	L EH T ER
LETTERS	L EH T ER Z
LETTING	L EH T IH NG
LEVELLED	L EH V AH L D
LEWIS	L UW IH S
LIABLE	L AY AH B AH L
LIBERAL	L IH B ER AH L
LIBERAL(2)	L IH B R AH L
LIBERALITY	L IH B ER AE L AH T IY
LIBERALLY	L IH B ER AH L IY
LIBERALLY(2)	L IH B R AH L IY
LIBERTIES	L IH B ER T IY Z
LIBERTY	L IH B ER T IY
LIBRARY	L AY B R EH R IY
LIBRIVOX	L IH B R AH V AH K S
LICENCE	L AY S AH N S
LICENTIOUSNESS	L AY S AH N T IY AH S N AH S
LIE	L AY
LIES	L AY Z
LIEU	L UW
LIEU(2)	L Y UW
LIEUTENANT'S	L OO T EH N axn T
LIFE	L AY F
LIFETIME	L AY F T AY M
LIFT	L IH F T
LIFTED	L IH F T AH D
LIFTED(2)	L IH F T IH D
LIGHT	L AY T
LIGHTED	L AY T AH D
LIGHTED(2)	L AY T IH D
LIGHTNESS	L AY T N AH S
LIKE	L AY K
LIKED	L AY K T
LIKELIHOOD	L AY K L IY HH UH D
LIKELY	L AY K L IY
LIKENESS	L AY K N AH S
LIKES	L AY K S
LIKEWISE	L AY K W AY Z
LIKING	L AY K IH NG
LIMITS	L IH M AH T S
LIMITS(2)	L IH M IH T S
LINE	L AY N
LINES	L AY N Z
LINGERING	L IH NG G ER IH NG
LINGERING(2)	L IH NG G R IH NG
LIPS	L IH P S
LIST	L IH S T
LISTEN	L IH S AH N
LISTENED	L IH S AH N D
LISTENER	L IH S AH N ER
LISTENER(2)	L IH S N ER
LISTENING	L IH S AH N IH NG
LISTENING(2)	L IH S N IH NG
LITTLE	L IH T AH L
LIVE	L AY V
LIVE(2)	L IH V
LIVED	L AY V D
LIVED(2)	L IH V D
LIVELIEST	L AY V L IY AH S T
LIVELINESS	L AY V L IY N AH S
LIVELY	L AY V L IY
LIVERPOOL	L IH V ER P UW L
LIVERY	L IH V ER IY
LIVES	L IH V Z
LIVES(2)	L AY V Z
LIVING	L IH V IH NG
LIVINGS	L IH V IH NG Z
LIZZY	L IH Z IY
LIZZY'S	L I Z II Z
LL	EH L
LOBBY	L AA B IY
LOCAL	L OW K AH L
LOCK	L AA K
LODGE	L AA JH
LODGES	L AA JH AH Z
LODGES(2)	L AA JH IH Z
LODGINGS	L AA JH IH NG Z
LOFTY	L AO F T IY
LONDON	L AH N D AH N
LONG	L AO NG
LONGBOURN	L AO ng B OW R N
LONGED	L AO NG D
LONGER	L AO NG G ER
LONGING	L AO NG IH NG
LOO	L UW
LOOK	L UH K
LOOKED	L UH K T
LOOKING	L UH K IH NG
LOOKS	L UH K S
LOOSE	L UW S
LORD	L AO R D
LOSE	L UW Z
LOSER	L UW Z ER
LOSING	L UW Z IH NG
LOSS	L AO S
LOSSES	L AO S AH Z
LOSSES(2)	L AO S IH Z
LOST	L AO S T
LOT	L AA T
LOT(2)	L AO T
LOTTERY	L AA T ER IY
LOUD	L AW D
LOUDER	L AW D ER
LOUDLY	L AW D L IY
LOUISA	L UW IY Z AH
LOVE	L AH V
LOVED	L AH V D
LOVELIEST	L AX V L I EH S T
LOVELINESS	L AH V L IY N AH S
LOVELY	L AH V L IY
LOVER	L AH V ER
LOVERS	L AH V ER Z
LOVES	L AH V Z
LOVING	L AH V IH NG
LOW	L OW
LOWER	L OW ER
LOWEST	L OW AH S T
LOWNESS	L OW N AH S
LUCAS	L UW K AH S
LUCAS'S	L UW K AH S IH Z
LUCASES	L OO K AX S ez
LUCK	L AH K
LUCKIEST	L AH K IY AH S T
LUCKILY	L AH K AH L IY
LUCKLESS	L AH K L AH S
LUCKY	L AH K IY
LUNCHEON	L AH N CH AH N
LURKING	L ER K IH NG
LUSTRE	L AH S T ER
LYDIA	L IH D IY AH
LYDIA'S	L I D I AA Z
LYING	L AY IH NG
M	EH M
MA	M AA
MADAM	M AE D AH M
MADE	M EY D
MAGISTRATE	M AE JH AH S T R EY T
MAGISTRATE(2)	M AE JH IH S T R EY T
MAGNITUDE	M AE G N AH T UW D
MAID	M EY D
MAIDEN	M EY D AH N
MAINTAIN	M EY N T EY N
MAINTAINED	M EY N T EY N D
MAINTAINING	M EY N T EY N IH NG
MAKE	M EY K
MAKES	M EY K S
MAKING	M EY K IH NG
MALE	M EY L
MALICE	M AE L AH S
MALICE(2)	M AE L IH S
MALICIOUS	M AH L IH SH AH S
MAMMA	M AA M AH
MAN	M AE N
MAN'S	M AE N Z
MANAGE	M AE N AH JH
MANAGE(2)	M AE N IH JH
MANAGED	M AE N AH JH D
MANAGED(2)	M AE N IH JH D
MANAGEMENT	M AE N AH JH M AH N T
MANAGEMENT(2)	M AE N IH JH M AH N T
MANAGER	M AE N AH JH ER
MANAGER(2)	M AE N IH JH ER
MANIFOLD	M AE N AH F OW L D
MANIFOLD(2)	M AE N IH F OW L D
MANKIND	M AE N K AY N D
MANNER	M AE N ER
MANNERS	M AE N ER Z
MANOEUVRE	M axn OO V ER
MANOR	M AE N ER
MANSION	M AE N SH AH N
MANTELPIECE	M AE N T AH L P IY S
MANY	M EH N IY
MARCH	M AA R CH
MARIA	M ER IY AH
MARIA'S	M ER IY AH Z
MARK	M AA R K
MARKED	M AA R K T
MARKET	M AA R K AH T
MARKET(2)	M AA R K IH T
MARKS	M AA R K S
MARRIAGE	M EH R IH JH
MARRIED	M EH R IY D
MARRY	M EH R IY
MARRYING	M EH R IY IH NG
MARY	M EH R IY
MARY'S	M EH R IY Z
MASTER	M AE S T ER
MASTER'S	M AE S T ER Z
MASTERLY	M AE S T ER L IY
MASTERS	M AE S T ER Z
MATCH	M AE CH
MATERIAL	M AH T IH R IY AH L
MATERIALLY	M AH T IH R IY AH L IY
MATERNAL	M AH T ER N AH L
MATLOCK	M AE T L AA K
MATRIMONIAL	M AE T R AH M OW N IY AH L
MATRIMONY	M AE T R AH M OW N IY
MATTER	M AE T ER
MATTERS	M AE T ER Z
MATURE	M AH CH UH R
MATURE(2)	M AH T Y UH R
MAY	M EY
MAYORALTY	M EY ER AH L T IY
ME	M IY
MEADOWS	M EH D OW Z
MEAN	M IY N
MEANEST	M IY N AH S T
MEANING	M IY N IH NG
MEANLY	M IY N L IY
MEANNESS	M IY N N AH S
MEANS	M IY N Z
MEANT	M EH N T
MEANTIME	M IY N T AY M
MEANWHILE	M IY N W AY L
MEASURE	M EH ZH ER
MEASURES	M EH ZH ER Z
MEAT	M IY T
MECHANICALLY	M AH K AE N IH K L IY
MEDIOCRITY	M IY D IY AA K R AH T IY
MEDITATE	M EH D AH T EY T
MEDITATED	M EH D AH T EY T IH D
MEDITATING	M EH D AH T EY T IH NG
MEDITATION	M EH D AH T EY SH AH N
MEDITATIONS	M EH D IH T EY SH AH N Z
MEET	M IY T
MEETING	M IY T IH NG
MEETINGS	M IY T IH NG Z
MEETS	M IY T S
MELANCHOLY	M EH L AH N K AA L IY
MEMBER	M EH M B ER
MEMORIES	M EH M ER IY Z
MEMORY	M EH M ER IY
MEN	M EH N
MEND	M EH N D
MENTION	M EH N SH AH N
MENTIONED	M EH N SH AH N D
MENTIONING	M EH N SH AH N IH NG
MERCENARY	M ER S AH N EH R IY
MERE	M IH R
MERELY	M IH R L IY
MERIT	M EH R AH T
MERITED	M EH R IH T IH D
MERITS	M EH R AH T S
MERITS(2)	M EH R IH T S
MERRY	M EH R IY
MERYTON	M EH R II T axn
MESS	M EH S
MESSAGE	M EH S AH JH
MESSAGE(2)	M EH S IH JH
MESSAGES	M EH S AH JH AH Z
MESSAGES(2)	M EH S IH JH IH Z
MET	M EH T
METCALF	M EH T K AE F
METHOD	M EH TH AH D
MICHAELMAS	M AH CH IY L M AH Z
MIDDLE	M IH D AH L
MIEN	M IY N
MIGHT	M AY T
MILD	M AY L D
MILDLY	M AY L D L IY
MILDNESS	M AY L D N AH S
MILE	M AY L
MILES	M AY L Z
MILES(2)	M AY AH L Z
MILITARY	M IH L AH T EH R IY
MILITARY(2)	M IH L IH T EH R IY
MILITIA	M AH L IH SH AH
MILITIA(2)	M IH L IH SH AH
MILLER'S	M IH L ER Z
MILLINER	M IH L IH N ER
MILLINER'S	M I L I N ER S
MINCE	M IH N S
MIND	M AY N D
MINDED	M AY N D AH D
MINDED(2)	M AY N D IH D
MINDFUL	M AY N D F AH L
MINDS	M AY N D Z
MINE	M AY N
MINGLED	M IH NG G AH L D
MINGLING	M IH NG G AH L IH NG
MINGLING(2)	M IH NG G L IH NG
MINIATURES	M IH N IY AH CH ER Z
MINIATURES(2)	M IH N IH CH ER Z
MINUTE	M IH N AH T
MINUTE(2)	M AY N UW T
MINUTE(3)	M AY N Y UW T
MINUTELY	M IH N AH T L IY
MINUTENESS	M IH N AH T N AH S
MINUTES	M IH N AH T S
MINUTEST	M AY N Y OO T EH S T
MIRACULOUS	M ER AE K Y AH L AH S
MIRTH	M ER TH
MISCHANCE	M I S CH AE N S
MISCHIEF	M IH S CH AH F
MISCHIEVOUSLY	M I S CH I V AX S L II
MISCONDUCT	M IH S K AA N D AH K T
MISERABLE	M IH Z ER AH B AH L
MISERABLE(2)	M IH Z R AH B AH L
MISERABLY	M IH Z ER AH B L IY
MISERABLY(2)	M IH Z R AH B L IY
MISERIES	M IH Z ER IY Z
MISERLY	M AY Z ER L IY
MISERY	M IH Z ER IY
MISFORTUNE	M IH S F AO R CH AH N
MISFORTUNES	M IH S F AO R CH AH N Z
MISLEAD	M IH S L IY D
MISLEADING	M IH S L IY D IH NG
MISLEADS	M IH S L IY D Z
MISLED	M IH S L EH D
MISMANAGEMENT	M IH S M AE N IH JH M AH N T
MISREPRESENTATION	M IH S R EH P R IH Z EH N T EY SH AH N
MISREPRESENTED	M IH S R EH P R IH Z EH N T IH D
MISREPRESENTED(2)	M IH S R EH P R IH Z EH N IH D
MISS	M IH S
MISSED	M IH S T
MISSENT	M I S EH N T
MISSING	M IH S IH NG
MISSISH	M I S I SH
MISTAKE	M IH S T EY K
MISTAKEN	M IH S T EY K AH N
MISTAKES	M IH S T EY K S
MISTOOK	M IH S T UH K
MISTRESS	M IH S T R AH S
MISTRUST	M IH S T R AH S T
MISUNDERSTAND	M IH S AH N D ER S T AE N D
MISUNDERSTOOD	M IH S AH N D ER S T UH D
MISUSED	M IH S Y UW Z D
MIX	M IH K S
MIXED	M IH K S T
MIXING	M IH K S IH NG
MIXTURE	M IH K S CH ER
MODE	M OW D
MODEL	M AA D AH L
MODERATE	M AA D ER AH T
MODERATE(2)	M AA D ER EY T
MODERATION	M AA D ER EY SH AH N
MODERN	M AA D ER N
MODEST	M AA D AH S T
MODESTY	M AA D AH S T IY
MOMENT	M OW M AH N T
MOMENT'S	M OW M AH N T S
MOMENTARY	M OW M AH N T EH R IY
MOMENTS	M OW M AH N T S
MONDAY	M AH N D IY
MONDAY(2)	M AH N D EY
MONEY	M AH N IY
MONOSYLLABLE	M OW N OW S I L AX B xl
MONOTONOUS	M AH N AA T AH N AH S
MONTH	M AH N TH
MONTH'S	M AH N TH S
MONTHLY	M AH N TH L IY
MONTHS	M AH N TH S
MORAL	M AO R AH L
MORALITY	M ER AE L AH T IY
MORALIZE	M AO R AH L AY Z
MORE	M AO R
MOREOVER	M AO R OW V ER
MORNING	M AO R N IH NG
MORNING'S	M AO R N IH NG Z
MORNINGS	M AO R N IH NG Z
MORRIS	M AO R AH S
MORRIS(2)	M AO R IH S
MORROW	M AA R OW
MORROW(2)	M AO R OW
MORTAL	M AO R T AH L
MORTIFICATION	M AO R T AH F AH K EY SH AH N
MORTIFICATIONS	M AO R T AH F AH K EY SH AH N Z
MORTIFIED	M AO R T AH F AY D
MORTIFIES	M AO R T I F AY S
MORTIFYING	M AO R T AH F AY IH NG
MOST	M OW S T
MOST(2)	M OW S
MOSTLY	M OW S T L IY
MOSTLY(2)	M OW S L IY
MOTHER	M AH DH ER
MOTHER'S	M AH DH ER Z
MOTION	M OW SH AH N
MOTIVE	M OW T IH V
MOTIVES	M OW T IH V Z
MOUNT	M AW N T
MOUNTAINS	M AW N T AH N Z
MOUNTING	M AW N T IH NG
MOUTH	M AW TH
MOUTHS	M AW DH Z
MOVE	M UW V
MOVED	M UW V D
MOVING	M UW V IH NG
MR	M IH S T ER
MR.	M IH S T ER
MRS	M IH S IH Z
MRS.	M IH S IH Z
MUCH	M AH CH
MUD	M AH D
MUFFIN	M AH F AH N
MULTITUDE	M AH L T AH T UW D
MULTITUDE(2)	M AH L T AH T Y UW D
MURMURS	M ER M ER Z
MUSIC	M Y UW Z IH K
MUSICAL	M Y UW Z IH K AH L
MUSLIN	M AH Z L AH N
MUSLINS	M AH Z L AH N Z
MUST	M AH S T
MUTUAL	M Y UW CH AH W AH L
MUTUALLY	M Y UW CH UW AH L IY
MY	M AY
MYSELF	M AY S EH L F
MYSTERY	M IH S T ER IY
NAME	N EY M
NAMED	N EY M D
NAMES	N EY M Z
NAMING	N EY M IH NG
NARRATIVE	N AE R AH T IH V
NARRATIVE(2)	N EH R AH T IH V
NARROW	N EH R OW
NARROW(2)	N AE R OW
NARROWEST	N EH R OW AH S T
NARROWLY	N EH R OW L IY
NASTY	N AE S T IY
NATURAL	N AE CH ER AH L
NATURAL(2)	N AE CH R AH L
NATURALLY	N AE CH ER AH L IY
NATURALLY(2)	N AE CH R AH L IY
NATURE	N EY CH ER
NATURED	N EY CH ER D
NATUREDLY	N EY CH ER D L IY
NAY	N EY
NEAR	N IH R
NEARER	N IH R ER
NEAREST	N IH R AH S T
NEARLY	N IH R L IY
NEARNESS	N I ER N EH S
NEAT	N IY T
NEATNESS	N IY T N AH S
NECESSARILY	N EH S AH S EH R AH L IY
NECESSARY	N EH S AH S EH R IY
NECESSITY	N AH S EH S AH T IY
NECESSITY(2)	N AH S EH S IH T IY
NECTARINES	N EH K T AX R II N S
NEED	N IY D
NEEDED	N IY D AH D
NEEDED(2)	N IY D IH D
NEEDLESS	N IY D L AH S
NEEDLESSLY	N IY D L AH S L IY
NEEDLEWORK	N IY D AH L W ER K
NEGATIVE	N EH G AH T IH V
NEGATIVED	N EH G AX T I V D
NEGLECT	N AH G L EH K T
NEGLECT(2)	N IH G L EH K T
NEGLECTED	N AH G L EH K T AH D
NEGLECTED(2)	N IH G L EH K T IH D
NEGLECTING	N IH G L EH K T IH NG
NEGLIGENCE	N EH G L AH JH AH N S
NEGLIGENCE(2)	N EH G L IH JH AH N S
NEGLIGENT	N EH G L AH JH AH N T
NEGLIGENT(2)	N EH G L IH JH AH N T
NEIGHBOUR	N EY B ER
NEIGHBOURHOOD	N EY B ER HH UH D
NEIGHBOURHOODS	N EY B ER HH U D Z
NEIGHBOURING	N EY B ER IH NG
NEIGHBOURS	N EY B ER Z
NEITHER	N IY DH ER
NEITHER(2)	N AY DH ER
NEPHEW	N EH F Y UW
NEPHEW'S	N EH F Y UW Z
NEPHEWS	N EH F Y UW Z
NERVES	N ER V Z
NERVOUS	N ER V AH S
NET	N EH T
NETHERFIELD	N EH DH ER F IY L D
NETTING	N EH T IH NG
NETTLED	N EH T AH L D
NEVER	N EH V ER
NEW	N UW
NEW(2)	N Y UW
NEWCASTLE	N UW K AE S AH L
NEWCOMERS	N UW K AH M ER Z
NEWEST	N UW AH S T
NEWLY	N UW L IY
NEWS	N UW Z
NEWS(2)	N Y UW Z
NEWSPAPER	N UW Z P EY P ER
NEXT	N EH K S T
NEXT(2)	N EH K S
NICE	N AY S
NICE(2)	N IY S
NICELY	N AY S L IY
NICEST	N AY S IH S T
NICHOLLS	N IH K AH L Z
NIECE	N IY S
NIECE'S	N IY S IH Z
NIECES	N IY S IH Z
NIGHT	N AY T
NIGHTCAP	N AY T K AE P
NINE	N AY N
NNIGHT	N AY T
NO	N OW
NOBLE	N OW B AH L
NOBLER	N OW B L ER
NOBLEST	N OW B L IH S T
NOBODY	N OW B AA D IY
NOBODY(2)	N OW B AH D IY
NOBODY'S	N OW B AA D IY Z
NOBODY'S(2)	N OW B AH D IY Z
NODS	N AA D Z
NOISE	N OY Z
NOISY	N OY Z IY
NOMINALLY	N AA M AH N AH L IY
NONE	N AH N
NONSENSE	N AA N S EH N S
NONSENSICAL	N AA N S EH N S IH K AH L
NOON	N UW N
NOR	N AO R
NORTH	N AO R TH
NORTHERN	N AO R DH ER N
NORTHWARD	N AO R TH W ER D
NORTHWARDS	N AO R TH W ER D Z
NOSE	N OW Z
NOT	N AA T
NOTE	N OW T
NOTES	N OW T S
NOTHING	N AH TH IH NG
NOTHINGNESS	N AH TH IH NG N AH S
NOTHINGS	N AH TH IH NG Z
NOTICE	N OW T AH S
NOTICE(2)	N OW T IH S
NOTICED	N OW T AH S T
NOTICING	N OW T IH S IH NG
NOTION	N OW SH AH N
NOTIONS	N OW SH AH N Z
NOURISHES	N ER IH SH AH Z
NOVELS	N AA V AH L Z
NOVELTY	N AA V AH L T IY
NOVEMBER	N OW V EH M B ER
NOW	N AW
NOWADAYS	N AW AH D EY Z
NOWHERE	N OW W EH R
NOWHERE(2)	N OW HH W EH R
NUMBER	N AH M B ER
NUMEROUS	N UW M ER AH S
NUPTIALS	N AH P T IY AH L Z
NURSING	N ER S IH NG
O	OW
OAKHAM	OW K HH AE M
OAKS	OW K S
OBEISANCE	OW B EY Z AH N S
OBEY	OW B EY
OBEYED	OW B EY D
OBJECT	AA B JH EH K T
OBJECT(2)	AH B JH EH K T
OBJECTED	AH B JH EH K T AH D
OBJECTING	AH B JH EH K T IH NG
OBJECTION	AH B JH EH K SH AH N
OBJECTIONABLE	AH B JH EH K SH AH N AH B AH L
OBJECTIONS	AH B JH EH K SH AH N Z
OBJECTS	AA B JH EH K T S
OBJECTS(2)	AH B JH EH K T S
OBJECTS(3)	AA B JH EH K S
OBJECTS(4)	AH B JH EH K S
OBLIGATION	AA B L AH G EY SH AH N
OBLIGATIONS	AA B L AH G EY SH AH N Z
OBLIGE	AH B L AY JH
OBLIGED	AH B L AY JH D
OBLIGING	AH B L AY JH IH NG
OBLIGINGLY	AH B L AY JH IH NG L IY
OBSEQUIOUS	AH B S IY K W IY AH S
OBSEQUIOUSNESS	AH B S IY K W IY AH S N AH S
OBSERVANCES	AH B Z ER V AH N S IH Z
OBSERVATION	AA B Z ER V EY SH AH N
OBSERVATIONS	AA B Z ER V EY SH AH N Z
OBSERVE	AH B Z ER V
OBSERVED	AH B Z ER V D
OBSERVER	AH B Z ER V ER
OBSERVING	AH B Z ER V IH NG
OBSTACLES	AA B S T AH K AH L Z
OBSTINACY	AA B S T AH N AH S IY
OBSTINATE	AA B S T AH N AH T
OBTAIN	AH B T EY N
OBTAINED	AH B T EY N D
OBTRUDED	AH B T R UW D IH D
OBVIOUS	AA B V IY AH S
OCCASION	AH K EY ZH AH N
OCCASION'S	AH K EY ZH AH N Z
OCCASIONAL	AH K EY ZH AH N AH L
OCCASIONALLY	AH K EY ZH AH N AH L IY
OCCASIONALLY(2)	AH K EY ZH N AH L IY
OCCASIONALLY(3)	AH K EY ZH AH N L IY
OCCASIONED	AH K EY ZH AH N D
OCCASIONS	AH K EY ZH AH N Z
OCCUPATION	AA K Y AH P EY SH AH N
OCCUPIED	AA K Y AH P AY D
OCCUPIES	AA K Y AH P AY Z
OCCUPY	AA K Y AH P AY
OCCUR	AH K ER
OCCURRED	AH K ER D
OCCURRENCES	AH K ER AH N S IH Z
OCCURRING	AH K ER IH NG
OCCURS	AH K ER Z
OCTOBER	AA K T OW B ER
ODD	AA D
ODDITIES	AA D AH T IY Z
ODDITY	AA D AH T IY
ODDLY	AA D L IY
ODIOUS	OW D IY AH S
OF	AH V
OFF	AO F
OFFENCE	AH F EH N S
OFFEND	AH F EH N D
OFFENDED	AH F EH N D AH D
OFFENDED(2)	AH F EH N D IH D
OFFENDING	AH F EH N D IH NG
OFFENSE	AH F EH N S
OFFENSES	AH F EH N S IH Z
OFFENSIVE	AH F EH N S IH V
OFFER	AO F ER
OFFERED	AO F ER D
OFFERING	AO F ER IH NG
OFFERING(2)	AO F R IH NG
OFFERS	AO F ER Z
OFFICE	AO F AH S
OFFICER	AO F AH S ER
OFFICER(2)	AO F IH S ER
OFFICERS	AO F AH S ER Z
OFFICERS(2)	AO F IH S ER Z
OFFICIOUS	AH F IH SH AH S
OFFICIOUSNESS	AH F IH SH AH S N AH S
OFTEN	AO F AH N
OFTEN(2)	AO F T AH N
OFTENER	AO F AH N ER
OFTENER(2)	AO F T AH N ER
OH	OW
OLD	OW L D
OLDER	OW L D ER
OLIVE	AA L AH V
OLIVE(2)	AA L IH V
OMEN	OW M AH N
OMIT	OW M IH T
OMITTED	OW M IH T AH D
OMITTED(2)	OW M IH T IH D
ON	AA N
ON(2)	AO N
ONCE	W AH N S
ONE	W AH N
ONE(2)	HH W AH N
ONE'S	W AH N Z
ONES	W AH N Z
ONLY	OW N L IY
OPEN	OW P AH N
OPENED	OW P AH N D
OPENING	OW P AH N IH NG
OPENLY	OW P AH N L IY
OPENNESS	OW P AH N N AH S
OPENNESS(2)	OW P AH N AH S
OPERATED	AA P ER EY T AH D
OPINION	AH P IH N Y AH N
OPINIONS	AH P IH N Y AH N Z
OPPORTUNITIES	AA P ER T UW N AH T IY Z
OPPORTUNITY	AA P ER T UW N AH T IY
OPPOSE	AH P OW Z
OPPOSED	AH P OW Z D
OPPOSITE	AA P AH Z AH T
OPPOSITE(2)	AA P Z AH T
OPPOSITION	AA P AH Z IH SH AH N
OPPRESSED	AH P R EH S T
OPPRESSIVELY	AH P R EH S IH V L IY
OR	AO R
OR(2)	ER
ORDAINED	AO R D EY N D
ORDER	AO R D ER
ORDERED	AO R D ER D
ORDERLY	AO R D ER L IY
ORDERS	AO R D ER Z
ORDINARY	AO R D AH N EH R IY
ORDINATION	AO R D AH N EY SH AH N
ORG	AO R G
ORGAVE	AO R G EY V
ORGE	AO R JH
ORGET	AO R JH AH T
ORGETFULNESS	AO R JH EH T Y UH L N AH S
ORGETS	AO R JH AH T S
ORGETTING	AO R JH EH T AH NG
ORGIANA	AO R JH IY AH N AH
ORGIANA'S	AO R JH IY AH N AH Z
ORGIVE	AO R JH AH V
ORGIVEN	AO R JH AH V AH N
ORGIVENESS	AO R JH AY V N AH S
ORGIVING	AO R JH AH V AH NG
ORGOT	AO R G AH T
ORGOTTEN	AO R G AA T AH N
ORIGINAL	ER IH JH AH N AH L
ORIGINALLY	ER IH JH AH N AH L IY
ORIGINALLY(2)	ER IH JH N AH L IY
ORIGINATE	ER IH JH AH N EY T
ORIGINATED	ER IH JH AH N EY T AH D
ORIGINATED(2)	AO R IH JH AH N EY T IH D
ORNAMENTS	AO R N AH M AH N T S
OSTENTATION	AO S T EH N T EY SH AH N
OSTENTATIOUS	AA S T AH N T EY SH AH S
OTHER	AH DH ER
OTHER'S	AH DH ER Z
OTHERS	AH DH ER Z
OTHERWISE	AH DH ER W AY Z
OUGHT	AO T
OUR	AW ER
OUR(2)	AW R
OUR(3)	AA R
OURS	AW ER Z
OURS(2)	AA R Z
OURS(3)	AW R Z
OURSELVES	AW ER S EH L V Z
OURSELVES(2)	AA R S EH L V Z
OUT	AW T
OUTDONE	AW T D AH N
OUTLIVED	AW T L IH V D
OUTRUN	AW T R AH N
OUTSTRIP	AW T S T R IH P
OUTSTRIPPED	AW T S T R IH P T
OVER	OW V ER
OVERBEARING	OW V ER B EH R IH NG
OVERCAME	OW V ER K EY M
OVERCOME	OW V ER K AH M
OVERCOMING	OW V ER K AH M IH NG
OVERFLOWING	OW V ER F L OW IH NG
OVERFLOWS	OW V ER F L OW Z
OVERHEAR	OW V ER HH IY R
OVERHEARD	OW V ER HH ER D
OVERHEARINGS	OW V ER HH I ER I ng Z
OVERJOYED	OW V ER JH OY D
OVERLOOK	OW V ER L UH K
OVERLOOKED	OW V ER L UH K T
OVERPOWER	OW V ER P AW ER
OVERPOWERED	OW V ER P AW ER D
OVERPOWERING	OW V ER P AW R IH NG
OVERRULED	OW V ER R UW L D
OVERSET	OW V ER S EH T
OVERSPREAD	OW V ER S P R EH D
OVERSPREADING	OW V ER S P R EH D IH NG
OVERTAKEN	OW V ER T EY K AH N
OVERTHROW	OW V ER TH R OW
OVERTHROWING	OW V ER TH R OW IH NG
OVERTHROWN	OW V ER TH R OW N
OVERTOOK	OW V ER T UH K
OVERTURES	OW V ER CH UH R Z
OWE	OW
OWED	OW D
OWES	OW Z
OWING	OW IH NG
OWN	OW N
OWNED	OW N D
OWNER	OW N ER
OWNS	OW N Z
OXFORD	AA K S F ER D
P	P IY
PACE	P EY S
PACK	P AE K
PACKED	P AE K T
PACKING	P AE K IH NG
PADDOCK	P AE D AH K
PAGE	P EY JH
PAGES	P EY JH AH Z
PAGES(2)	P EY JH IH Z
PAID	P EY D
PAIN	P EY N
PAINFUL	P EY N F AH L
PAINFULLY	P EY N F AH L IY
PAINING	P EY N I ng
PAINS	P EY N Z
PAINT	P EY N T
PAINTER	P EY N T ER
PAINTER(2)	P EY N ER
PAINTINGS	P EY N T IH NG Z
PAINTINGS(2)	P EY N IH NG Z
PAIR	P EH R
PALATABLE	P AE L AH T AH B AH L
PALE	P EY L
PALER	P EY L ER
PALES	P EY L Z
PALING	P EY L IH NG
PALINGS	P EY L I ng Z
PALLIATION	P AE L I EY SH axn
PALTRY	P AO L T R IY
PANEGYRIC	P AE N AX G AY R I K
PANG	P AE NG
PANTING	P AE N T IH NG
PAPA	P AA P AH
PAPER	P EY P ER
PAPERS	P EY P ER Z
PARADE	P ER EY D
PARADING	P ER EY D IH NG
PARASOL	P AE R AX S AO L
PARCELS	P AA R S AH L Z
PARDON	P AA R D AH N
PARENT'S	P EH R AH N T S
PARENTAL	P ER EH N T AH L
PARENTS	P EH R AH N T S
PARISH	P AE R IH SH
PARISH(2)	P EH R IH SH
PARISHIONERS	P ER IH SH AH N ER Z
PARK	P AA R K
PARLOUR	P AA R L ER
PARSONAGE	P AA R S AH N IH JH
PART	P AA R T
PARTAKE	P AA R T EY K
PARTED	P AA R T AH D
PARTED(2)	P AA R T IH D
PARTIAL	P AA R SH AH L
PARTIALITY	P AA R SH IY AE L AH T IY
PARTICIPATION	P AA R T IH S AH P EY SH AH N
PARTICULAR	P ER T IH K Y AH L ER
PARTICULAR(2)	P AA T IH K Y AH L ER
PARTICULARLY	P AA R T IH K Y AH L ER L IY
PARTICULARLY(2)	P ER T IH K Y AH L ER L IY
PARTICULARS	P ER T IH K Y AH L ER Z
PARTIES	P AA R T IY Z
PARTING	P AA R T IH NG
PARTLY	P AA R T L IY
PARTNER	P AA R T N ER
PARTNERS	P AA R T N ER Z
PARTRIDGES	P AA R T R IH JH IH Z
PARTS	P AA R T S
PARTY	P AA R T IY
PASS	P AE S
PASSAGE	P AE S AH JH
PASSAGE(2)	P AE S IH JH
PASSAGES	P AE S AH JH AH Z
PASSAGES(2)	P AE S IH JH IH Z
PASSED	P AE S T
PASSING	P AE S IH NG
PASSION	P AE SH AH N
PASSIONS	P AE SH AH N Z
PAST	P AE S T
PATCHED	P AE CH T
PATH	P AE TH
PATHETIC	P AH TH EH T IH K
PATIENCE	P EY SH AH N S
PATIENT	P EY SH AH N T
PATRON	P EY T R AH N
PATRONAGE	P AE T R AH N IH JH
PATRONAGE(2)	P EY T R AH N AH JH
PATRONAGE(3)	P EY T R AH N IH JH
PATRONESS	P EY T R AH N AH S
PAUSE	P AO Z
PAUSED	P AO Z D
PAUSES	P AO Z AH Z
PAUSES(2)	P AO Z IH Z
PAUSING	P AO Z IH NG
PAVEMENT	P EY V M AH N T
PAY	P EY
PAYING	P EY IH NG
PAYMENT	P EY M AH N T
PEACE	P IY S
PEACHES	P IY CH AH Z
PEACHES(2)	P IY CH IH Z
PEAK	P IY K
PECULIAR	P AH K Y UW L Y ER
PECULIAR(2)	P IH K Y UW L Y ER
PECULIARITIES	P IH K Y UW L IY EH R AH T IY Z
PECULIARITY	P IH K Y UW L IY EH R AH T IY
PECULIARLY	P IH K Y UW L Y ER L IY
PECUNIARY	P EH K Y UW N IY EH R IY
PEDANTIC	P AH D AE N T IH K
PEEP	P IY P
PEEVISH	P IY V IH SH
PEMBERLEY	P EH M B ER L II
PEN	P EH N
PENANCE	P EH N AH N S
PENETRATION	P EH N AH T R EY SH AH N
PENITENT	P EH N IH T IH N T
PENS	P EH N Z
PEOPLE	P IY P AH L
PEOPLE'S	P IY P AH L Z
PER	P ER
PERCEIVE	P ER S IY V
PERCEIVED	P ER S IY V D
PERCEIVING	P ER S IY V IH NG
PERCEPTIBLE	P ER S EH P T AH B AH L
PERFECT	P ER F EH K T
PERFECT(2)	P ER F IH K T
PERFECTIONS	P ER F AH K SH AH N Z
PERFECTLY	P ER F AH K T L IY
PERFECTLY(2)	P ER F AH K L IY
PERFORCE	P ER F AO R S
PERFORM	P ER F AO R M
PERFORMANCE	P ER F AO R M AH N S
PERFORMED	P ER F AO R M D
PERFORMER	P ER F AO R M ER
PERFORMERS	P ER F AO R M ER Z
PERFORMS	P ER F AO R M Z
PERHAPS	P ER HH AE P S
PERIOD	P IH R IY AH D
PERIODS	P IH R IY AH D Z
PERMANENT	P ER M AH N AH N T
PERMISSION	P ER M IH SH AH N
PERMIT	P ER M IH T
PERMITTED	P ER M IH T AH D
PERMITTED(2)	P ER M IH T IH D
PERPETUAL	P ER P EH CH UW AH L
PERPETUALLY	P ER P EH CH UW AH L IY
PERPLEXITY	P ER P L EH K S AH T IY
PERSEVERANCE	P ER S AH V IH R AH N S
PERSEVERED	P ER S AH V IH R D
PERSEVERING	P ER S AH V IH R IH NG
PERSEVERINGLY	P ER S EH V II ER I ng L II
PERSIST	P ER S IH S T
PERSISTED	P ER S IH S T AH D
PERSISTED(2)	P ER S IH S T IH D
PERSISTING	P ER S IH S T IH NG
PERSISTS	P ER S IH S T S
PERSISTS(2)	P ER S IH S S
PERSISTS(3)	P ER S IH S
PERSON	P ER S AH N
PERSON'S	P ER S AH N Z
PERSONAGE	P ER S AH N IH JH
PERSONAGES	P ER S OW N EY JH ez
PERSONAL	P ER S IH N IH L
PERSONS	P ER S AH N Z
PERSUADE	P ER S W EY D
PERSUADED	P ER S W EY D AH D
PERSUADED(2)	P ER S W EY D IH D
PERSUASION	P ER S W EY ZH AH N
PERSUASIONS	P ER S W EY ZH AH N Z
PERTURBATION	P ER T ER B EY SH AH N
PERTURBED	P ER T ER B D
PERUSAL	P ER UW Z AH L
PERUSING	P ER UW Z IH NG
PERVERSE	P ER V ER S
PERVERSENESS	P ER V ER S N AH S
PETITION	P AH T IH SH AH N
PETITIONED	P AH T IH SH AH N D
PETRIFIED	P EH T R AH F AY D
PETTICOAT	P EH T IY K OW T
PETULANCE	P EH CH AH L AH N S
PHAETON	F EY T axn
PHILIPS	F IH L AH P S
PHILIPS(2)	F IH L IH P S
PHILLIP'S	F IH L IH P S
PHILLIPS	F IH L IH P S
PHILLIPS'S	F IH L IH P S IH Z
PHILLIPSES	F I L I P S ez
PHILOSOPHER	F AH L AA S AH F ER
PHILOSOPHIC	F IH L AH S AA F IH K
PHILOSOPHY	F AH L AA S AH F IY
PHYSICIANS	F AH Z IH SH AH N Z
PHYSICIANS(2)	F IH Z IH SH AH N Z
PIANOFORTE	P IY AE N OW F AO R T EY
PICTURE	P IH K CH ER
PICTURED	P IH K CH ER D
PICTURES	P IH K CH ER Z
PICTURESQUE	P IH K CH ER AH S K
PIECE	P IY S
PIECES	P IY S AH Z
PIECES(2)	P IY S IH Z
PIES	P AY Z
PIGS	P IH G Z
PILING	P AY L IH NG
PIN	P IH N
PIQUED	P IY K T
PIQUET	P IH K AH T
PITCHED	P IH CH T
PITIABLE	P IH T IY AH B AH L
PITIED	P IH T IY D
PITIFUL	P IH T AH F AH L
PITY	P IH T IY
PLACE	P L EY S
PLACED	P L EY S T
PLACES	P L EY S AH Z
PLACES(2)	P L EY S IH Z
PLACING	P L EY S IH NG
PLAGUE	P L EY G
PLAIN	P L EY N
PLAINER	P L EY N ER
PLAINLY	P L EY N L IY
PLAN	P L AE N
PLANNED	P L AE N D
PLANNING	P L AE N IH NG
PLANS	P L AE N Z
PLANT	P L AE N T
PLANTATION	P L AE N T EY SH AH N
PLATE	P L EY T
PLAY	P L EY
PLAYED	P L EY D
PLAYERS	P L EY ER Z
PLAYFUL	P L EY F AH L
PLAYFULNESS	P L EY F AH L N AH S
PLAYING	P L EY IH NG
PLAYS	P L EY Z
PLEAD	P L IY D
PLEADED	P L IY D AH D
PLEADED(2)	P L IY D IH D
PLEASANT	P L EH Z AH N T
PLEASANTER	P L EH Z AH N T ER
PLEASANTEST	P L EH Z AH N T AH S T
PLEASANTLY	P L EH Z AH N T L IY
PLEASANTNESS	P L EH Z AH N T N AH S
PLEASANTRY	P L EH Z AH N T R IY
PLEASE	P L IY Z
PLEASED	P L IY Z D
PLEASES	P L IY Z IH Z
PLEASING	P L IY Z IH NG
PLEASURE	P L EH ZH ER
PLEASURES	P L EH ZH ER Z
PLEDGED	P L EH JH D
PLENTIFUL	P L EH N T AH F AH L
PLENTIFUL(2)	P L EH N T IH F AH L
PLENTIFUL(3)	P L EH N AH F AH L
PLENTIFUL(4)	P L EH N IH F AH L
PLENTY	P L EH N T IY
PLENTY(2)	P L EH N IY
PLIANCY	P L AY EH N S II
POCKET	P AA K AH T
POETRY	P OW AH T R IY
POINT	P OY N T
POINTED	P OY N T AH D
POINTED(2)	P OY N AH D
POINTED(3)	P OY N T IH D
POINTEDLY	P OY N T IH D L IY
POINTEDLY(2)	P OY N AH D L IY
POINTING	P OY N T IH NG
POINTS	P OY N T S
POLICY	P AA L AH S IY
POLISHED	P AA L IH SH T
POLITE	P AH L AY T
POLITELY	P AH L AY T L IY
POLITENESS	P AH L AY T N AH S
POLLUTED	P AH L UW T AH D
POLLUTED(2)	P AH L UW T IH D
POLLUTION	P AH L UW SH AH N
POMPOUS	P AA M P AH S
PONIES	P OW N IY Z
POOL	P UW L
POOLS	P UW L Z
POOR	P UH R
POORLY	P UH R L IY
POPE	P OW P
POPULAR	P AA P Y AH L ER
POPULARITY	P AA P Y AH L EH R AH T IY
PORRIDGE	P AO R AH JH
PORT	P AO R T
PORTION	P AO R SH AH N
PORTRAIT	P AO R T R AH T
PORTRAITS	P AO R T R AH T S
POSITION	P AH Z IH SH AH N
POSITIONS	P AH Z IH SH AH N Z
POSITIVE	P AA Z AH T IH V
POSITIVELY	P AA Z AH T IH V L IY
POSSESS	P AH Z EH S
POSSESSED	P AH Z EH S T
POSSESSES	P AH Z EH S AH Z
POSSESSES(2)	P AH Z EH S IH Z
POSSESSING	P AH Z EH S IH NG
POSSESSION	P AH Z EH SH AH N
POSSESSOR	P AH Z EH S ER
POSSIBILITIES	P AA S AH B IH L AH T IY Z
POSSIBILITY	P AA S AH B IH L AH T IY
POSSIBLE	P AA S AH B AH L
POSSIBLY	P AA S AH B L IY
POST	P OW S T
POSTERITY	P AA S T EH R AH T IY
POSTILIONS	P AO S T I L I axn S
POSTPONED	P OW S T P OW N D
POSTPONED(2)	P OW S P OW N D
POSTSCRIPT	P OW S K R IH P T
POSTSCRIPT(2)	P OW S T S K R IH P T
POULTRY	P OW L T R IY
POUNDS	P AW N D Z
POUNDS(2)	P AW N Z
POUR	P AO R
POURED	P AO R D
POURING	P AO R IH NG
POVERTY	P AA V ER T IY
POWDERING	P AW D ER IH NG
POWER	P AW ER
POWERFUL	P AW ER F AH L
POWERS	P AW ER Z
PRACTICE	P R AE K T AH S
PRACTICE(2)	P R AE K T IH S
PRACTISED	P R AE K T AH S T
PRACTISES	P R AE K T S ez
PRACTISING	P R AE K T AH S IH NG
PRAISE	P R EY Z
PRAISED	P R EY Z D
PRAISES	P R EY Z AH Z
PRAISES(2)	P R EY Z IH Z
PRATT	P R AE T
PRAY	P R EY
PREACHING	P R IY CH IH NG
PRECEDED	P R IH S IY D IH D
PRECEDED(2)	P R IY S IY D AH D
PRECEDED(3)	P R IY S IY D IH D
PRECEDING	P R IY S IY D IH NG
PRECIOUS	P R EH SH AH S
PRECIPITANCE	P R EH S I P I T EH N S
PRECIPITATE	P R IH S IH P IH T EY T
PRECISELY	P R IH S AY S L IY
PRECISELY(2)	P R IY S AY S L IY
PRECISION	P R IY S IH ZH AH N
PRECLUDING	P R IH K L UW D IH NG
PREDICT	P R IH D IH K T
PREDICT(2)	P R IY D IH K T
PREDOMINANCE	P R IH D AA M AH N AH N S
PREDOMINATE	P R IH D AA M AH N EY T
PREDOMINATE(2)	P R IH D AA M AH N AH T
PREFACED	P R EH F AH S T
PREFER	P R AH F ER
PREFER(2)	P R IH F ER
PREFER(3)	P R IY F ER
PREFERENCE	P R EH F ER AH N S
PREFERENCE(2)	P R EH F R AH N S
PREFERMENT	P R IH F ER M AH N T
PREFERRED	P R AH F ER D
PREFERRED(2)	P R IH F ER D
PREFERRED(3)	P R IY F ER D
PREJUDICE	P R EH JH AH D IH S
PREJUDICED	P R EH JH AH D AH S T
PREJUDICES	P R EH JH AH D IH S IH Z
PREMEDITATED	P R IY M EH D AH T EY T IH D
PREMEDITATION	P R IY M EH D AH T EY SH AH N
PREMISES	P R EH M AH S AH Z
PREPARATION	P R EH P ER EY SH AH N
PREPARATIONS	P R EH P ER EY SH AH N Z
PREPARE	P R IY P EH R
PREPARED	P R IY P EH R D
PREPARING	P R IY P EH R IH NG
PREPARING(2)	P ER P EH R IH NG
PREPOSSESSED	P R IY P AH Z EH S T
PREPOSSESSION	P R IY P AH Z EH SH AH N
PRESENCE	P R EH Z AH N S
PRESENT	P R EH Z AH N T
PRESENT(2)	P R IY Z EH N T
PRESENT(3)	P ER Z EH N T
PRESENTATION	P R EH Z AH N T EY SH AH N
PRESENTED	P R IY Z EH N T AH D
PRESENTED(2)	P ER Z EH N T AH D
PRESENTED(3)	P R IY Z EH N AH D
PRESENTED(4)	P ER Z EH N AH D
PRESENTLY	P R EH Z AH N T L IY
PRESENTS	P R EH Z AH N T S
PRESENTS(2)	P R IY Z EH N T S
PRESERVATION	P R EH Z ER V EY SH AH N
PRESERVATIVE	P R IY Z ER V AH T IH V
PRESERVE	P R AH Z ER V
PRESERVE(2)	P R IH Z ER V
PRESERVE(3)	P R IY Z ER V
PRESERVED	P R AH Z ER V D
PRESERVED(2)	P R IH Z ER V D
PRESERVED(3)	P R IY Z ER V D
PRESIDE	P R IH Z AY D
PRESIDE(2)	P R IY Z AY D
PRESIDED	P R IH Z AY D IH D
PRESIDED(2)	P R IY Z AY D AH D
PRESIDED(3)	P R IY Z AY D IH D
PRESS	P R EH S
PRESSED	P R EH S T
PRESSING	P R EH S IH NG
PRESSINGLY	P R EH S IH NG L IY
PRESUME	P R IH Z UW M
PRESUMED	P R AH Z UW M D
PRESUMED(2)	P R IH Z UW M D
PRESUMED(3)	P R IY Z UW M D
PRESUMING	P R IH Z UW M IH NG
PRESUMING(2)	P R IY Z UW M IH NG
PRESUMPTION	P R IH Z AH M P SH AH N
PRESUMPTION(2)	P R IY Z AH M P SH AH N
PRETENCE	P R IY T EH N S
PRETEND	P R IY T EH N D
PRETENDED	P R IY T EH N D AH D
PRETENDED(2)	P R IY T EH N D IH D
PRETENDING	P R IY T EH N D IH NG
PRETENSE	P R IY T EH N S
PRETENSION	P R IY T EH N SH AH N
PRETENSIONS	P R AH T EH N SH AH N Z
PRETTIER	P R IH T IY ER
PRETTIEST	P R IH T IY AH S T
PRETTY	P R IH T IY
PRETTYISH	P R I T I I SH
PREVAIL	P R IH V EY L
PREVAIL(2)	P R IY V EY L
PREVAILED	P R IH V EY L D
PREVAILED(2)	P R IY V EY L D
PREVAILING	P R IH V EY L IH NG
PREVAILING(2)	P R IY V EY L IH NG
PREVENT	P R IH V EH N T
PREVENT(2)	P R IY V EH N T
PREVENTED	P R IH V EH N T IH D
PREVENTED(2)	P R IY V EH N T IH D
PREVENTED(3)	P R IH V EH N IH D
PREVENTED(4)	P R IY V EH N IH D
PREVENTS	P R IH V EH N T S
PREVENTS(2)	P R IY V EH N T S
PREVIOUS	P R IY V IY AH S
PREVIOUSLY	P R IY V IY AH S L IY
PREY	P R EY
PRICE	P R AY S
PRIDE	P R AY D
PRIDED	P R AY D IH D
PRINCIPAL	P R IH N S AH P AH L
PRINCIPALLY	P R IH N S IH P L IY
PRINCIPLE	P R IH N S AH P AH L
PRINCIPLES	P R IH N S AH P AH L Z
PRIOR	P R AY ER
PRIVATE	P R AY V AH T
PRIVATELY	P R AY V AH T L IY
PRIVILEGE	P R IH V L AH JH
PRIVILEGE(2)	P R IH V L IH JH
PRIVILEGE(3)	P R IH V IH L AH JH
PRIVILEGE(4)	P R IH V IH L IH JH
PRIVILEGED	P R IH V L AH JH D
PRIVILEGED(2)	P R IH V L IH JH D
PRIVILEGED(3)	P R IH V IH L AH JH D
PRIVILEGED(4)	P R IH V IH L IH JH D
PRIZED	P R AY Z D
PRIZES	P R AY Z AH Z
PRIZES(2)	P R AY Z IH Z
PROBABILITIES	P R AA B AH B IH L AH T IY Z
PROBABILITY	P R AA B AH B IH L AH T IY
PROBABLE	P R AA B AH B AH L
PROBABLY	P R AA B AH B L IY
PROBABLY(2)	P R AA B L IY
PROBITY	P R OW B AH T IY
PROCEED	P R AH S IY D
PROCEED(2)	P R OW S IY D
PROCEED(3)	P ER S IY D
PROCEEDED	P R AH S IY D AH D
PROCEEDED(2)	P R OW S IY D IH D
PROCEEDING	P R AH S IY D IH NG
PROCEEDING(2)	P R OW S IY D IH NG
PROCEEDINGS	P R OW S IY D IH NG Z
PROCEEDINGS(2)	P R AH S IY D IH NG Z
PROCESS	P R AA S EH S
PROCESS(2)	P R AO S EH S
PROCLAIM	P R OW K L EY M
PROCURE	P R OW K Y UH R
PROCURED	P R OW K Y UH R D
PROCURING	P R OW K Y UH R IH NG
PRODIGIOUS	P R AH D IH JH AH S
PRODIGIOUSLY	P R OW D IH JH IH S L IY
PRODUCE	P R AH D UW S
PRODUCE(2)	P R OW D UW S
PRODUCED	P R AH D UW S T
PRODUCTIVE	P R AH D AH K T IH V
PRODUCTIVE(2)	P R OW D AH K T IH V
PRODUCTIVE(3)	P ER D AH K T IH V
PROFESS	P R AH F EH S
PROFESSED	P R AH F EH S T
PROFESSING	P R AH F EH S IH NG
PROFESSION	P R AH F EH SH AH N
PROFESSIONS	P R AH F EH SH AH N Z
PROFICIENCY	P R AH F IH SH AH N S IY
PROFICIENT	P R AA F IH SH AH N T
PROFIT	P R AA F AH T
PROFIT(2)	P R AA F IH T
PROFLIGACY	P R AO F L IH G AE S IY
PROFLIGATE	P R AO F L IH G EY T
PROFUSE	P R AH F Y UW S
PROFUSION	P R AH F Y UW ZH AH N
PROGNOSTICS	P R AO G N OW S T I K S
PROGRESS	P R AA G R EH S
PROGRESS(2)	P R AH G R EH S
PROGRESS(3)	P R OW G R EH S
PROHIBITED	P R OW HH IH B AH T AH D
PROJECT	P R AA JH EH K T
PROJECT(2)	P R AH JH EH K T
PROJECTED	P R AH JH EH K T AH D
PROMISE	P R AA M AH S
PROMISED	P R AA M AH S T
PROMISES	P R AA M AH S AH Z
PROMISING	P R AA M AH S IH NG
PROMOTE	P R AH M OW T
PROMOTED	P R AH M OW T AH D
PROMPT	P R AA M P T
PROMPTED	P R AA M P T AH D
PROMPTED(2)	P R AA M P T IH D
PRONE	P R OW N
PRONOUNCE	P R AH N AW N S
PRONOUNCED	P R AH N AW N S T
PRONOUNCING	P R AH N AW N S IH NG
PROOF	P R UW F
PROPENSITIES	P R AH P EH N S AH T IY Z
PROPER	P R AA P ER
PROPERLY	P R AA P ER L IY
PROPERTY	P R AA P ER T IY
PROPITIOUS	P R AH P IH SH AH S
PROPORTION	P R AH P AO R SH AH N
PROPORTIONATE	P R AH P AO R SH AH N AH T
PROPORTIONED	P R AH P AO R SH AH N D
PROPORTIONS	P R AH P AO R SH AH N Z
PROPOSAL	P R AH P OW Z AH L
PROPOSALS	P R AH P OW Z AH L Z
PROPOSE	P R AH P OW Z
PROPOSED	P R AH P OW Z D
PROPRIETOR	P R AH P R AY AH T ER
PROPRIETY	P R AH P R AY AH T IY
PROSPECT	P R AA S P EH K T
PROSPECTS	P R AA S P EH K T S
PROSPECTS(2)	P R AA S P EH K S
PROSPERITY	P R AA S P EH R AH T IY
PROSPEROUS	P R AA S P ER AH S
PROTECTION	P R AH T EH K SH AH N
PROTECTION(2)	P ER T EH K SH AH N
PROTEST	P R OW T EH S T
PROTEST(2)	P R AH T EH S T
PROTESTED	P R AH T EH S T AH D
PROTESTED(2)	P R OW T EH S T AH D
PROTESTING	P R AH T EH S T IH NG
PROTESTING(2)	P R OW T EH S T IH NG
PROUD	P R AW D
PROUDEST	P R AW D AH S T
PROUDLY	P R AW D L IY
PROVE	P R UW V
PROVED	P R UW V D
PROVERB	P R AA V ER B
PROVIDE	P R AH V AY D
PROVIDED	P R AH V AY D AH D
PROVIDED(2)	P R AH V AY D IH D
PROVIDING	P R AH V AY D IH NG
PROVING	P R UW V IH NG
PROVISION	P R AH V IH ZH AH N
PROVOCATIONS	P R AA V AH K EY SH AH N Z
PROVOKE	P R AH V OW K
PROVOKED	P R AH V OW K T
PROVOKING	P R AH V OW K IH NG
PROXY	P R AA K S IY
PRUDENCE	P R UW D AH N S
PRUDENT	P R UW D AH N T
PRUDENTIAL	P R UW D EH N CH AH L
PRUDENTIAL(2)	P R UW D EH N SH AH L
PRUDENTLY	P R UW D AH N T L IY
PUBLIC	P AH B L IH K
PUBLICLY	P AH B L IH K L IY
PUBLISH	P AH B L IH SH
PUDDLES	P AH D AH L Z
PUFFED	P AH F T
PULL	P UH L
PULVIS	P AX L V I S
PUNCH	P AH N CH
PUNCTUAL	P AH NG K CH UW AH L
PUNCTUALITY	P AH NG K CH UW AE L IH T IY
PUNCTUALLY	P AH NG K CH AH W AH L IY
PUNISH	P AH N IH SH
PUNISHMENT	P AH N IH SH M AH N T
PURCHASE	P ER CH AH S
PURCHASED	P ER CH AH S T
PURCHASES	P ER CH AH S AH Z
PURCHASES(2)	P ER CH AH S IH Z
PURE	P Y UH R
PURPORT	P ER P AO R T
PURPOSE	P ER P AH S
PURPOSELY	P ER P AH S L IY
PURSE	P ER S
PURSES	P ER S IH Z
PURSUE	P ER S UW
PURSUED	P ER S UW D
PURSUING	P ER S UW IH NG
PURSUIT	P ER S UW T
PURSUITS	P ER S UW T S
PUT	P UH T
PUTTING	P AH T IH NG
PUTTING(2)	P UH T IH NG
PUZZLE	P AH Z AH L
PUZZLED	P AH Z AH L D
PYRAMIDS	P IH R AH M IH D Z
QUADRILLE	K W AA D R IH L
QUALIFICATION	K W AA L AH F AH K EY SH AH N
QUALIFICATIONS	K W AA L AH F AH K EY SH AH N Z
QUALIFIED	K W AA L AH F AY D
QUALITIES	K W AA L AH T IY Z
QUALITY	K W AA L AH T IY
QUANTITY	K W AA N T AH T IY
QUANTITY(2)	K W AA N AH T IY
QUARREL	K W AO R AH L
QUARRELED	K W AO R AH L D
QUARRELING	K W AA R AH L IH NG
QUARRELING(2)	K W AA R L IH NG
QUARRELLING	K W AO R AH L IH NG
QUARRELSOME	K W AO R AH L S AH M
QUARTER	K W AO R T ER
QUARTER(2)	K AO R T ER
QUARTERED	K W AA R T ER D
QUARTERS	K W AO R T ER Z
QUERULOUS	K W EH R AH L AH S
QUEST	K W EH S T
QUESTION	K W EH S CH AH N
QUESTION(2)	K W EH SH AH N
QUESTIONED	K W EH S CH AH N D
QUESTIONS	K W EH S CH AH N Z
QUICK	K W IH K
QUICKLY	K W IH K L IY
QUICKNESS	K W IH K N AH S
QUIET	K W AY AH T
QUIETED	K W AY AH T AH D
QUIETED(2)	K W AY AH T IH D
QUIETER	K W AY AH T ER
QUIETLY	K W AY AH T L IY
QUIT	K W IH T
QUITE	K W AY T
QUITTED	K W IH T IH D
QUITTING	K W IH T IH NG
RACE	R EY S
RACKED	R AE K T
RAGE	R EY JH
RAGOUT	R AE G AW T
RAIL	R EY L
RAIN	R EY N
RAINED	R EY N D
RAISED	R EY Z D
RAISING	R EY Z IH NG
RALLIED	R AE L IY D
RAMBLE	R AE M B AH L
RAMBLED	R AE M B AH L D
RAMSGATE	R AE M S G EY T
RAN	R AE N
RANG	R AE NG
RANGE	R EY N JH
RANK	R AE NG K
RANT	R AE N T
RAPACITY	R AX P AE S I T II
RAPID	R AE P AH D
RAPID(2)	R AE P IH D
RAPIDITY	R AH P IH D AH T IY
RAPIDLY	R AE P AH D L IY
RAPTURE	R AE P CH ER
RAPTURES	R AE P CH ER Z
RAPTUROUS	R AE P CH ER AH S
RAPTUROUSLY	R AE P CH ER AH S L IY
RASHNESS	R AE SH N EH S
RATE	R EY T
RATED	R EY T AH D
RATED(2)	R EY T IH D
RATHER	R AE DH ER
RATHER(2)	R AH DH ER
RATIONAL	R AE SH AH N AH L
RATIONAL(2)	R AE SH N AH L
RATIONALLY	R AE SH AH N AH L IY
RATIONALLY(2)	R AE SH N AH L IY
RATTLE	R AE T AH L
RE	R EY
RE(2)	R IY
REACH	R IY CH
REACHED	R IY CH T
REACHING	R IY CH IH NG
READ	R EH D
READ(2)	R IY D
READER	R IY D ER
READILY	R EH D AH L IY
READINESS	R EH D IY N AH S
READING	R EH D IH NG
READING(2)	R IY D IH NG
READY	R EH D IY
REAL	R IY L
REALISED	R IY L IY Z D
REALITIES	R IY AE L AH T IY Z
REALLY	R IH L IY
REALLY(2)	R IY L IY
REANIMATED	R II AE N I M EY T ed
REAP	R IY P
REAPPEAR	R IY AH P IH R
REASON	R IY Z AH N
REASONABLE	R IY Z AH N AH B AH L
REASONABLE(2)	R IY Z N AH B AH L
REASONABLENESS	R IY Z AH N AH B AH L N AH S
REASONABLENESS(2)	R IY Z N AH B AH L N AH S
REASONABLY	R IY Z AH N AH B L IY
REASONING	R IY Z AH N IH NG
REASONS	R IY Z AH N Z
REBUKE	R IY B Y UW K
REBUKE(2)	R IH B Y UW K
RECALL	R IY K AO L
RECALL(2)	R IH K AO L
RECALLED	R IH K AO L D
RECEDE	R IH S IY D
RECEIPT	R IH S IY T
RECEIPT(2)	R IY S IY T
RECEIVE	R AH S IY V
RECEIVE(2)	R IH S IY V
RECEIVE(3)	R IY S IY V
RECEIVED	R AH S IY V D
RECEIVED(2)	R IH S IY V D
RECEIVED(3)	R IY S IY V D
RECEIVING	R AH S IY V IH NG
RECEIVING(2)	R IH S IY V IH NG
RECEIVING(3)	R IY S IY V IH NG
RECENT	R IY S AH N T
RECEPTION	R IH S EH P SH AH N
RECEPTION(2)	R IY S EH P SH AH N
RECITAL	R AH S AY T AH L
RECKON	R EH K AH N
RECKONED	R EH K AH N D
RECOGNIZED	R EH K AH G N AY Z D
RECOGNIZING	R EH K AH G N AY Z IH NG
RECOLLECT	R EH K AH L EH K T
RECOLLECT(2)	R IY K AH L EH K T
RECOLLECTED	R EH K AH L EH K T IH D
RECOLLECTED(2)	R IY K AH L EH K T IH D
RECOLLECTING	R EH K AH L EH K T IH NG
RECOLLECTING(2)	R IY K AH L EH K T IH NG
RECOLLECTION	R EH K AH L EH K SH AH N
RECOLLECTIONS	R EH K AH L EH K SH AH N Z
RECOMMENCED	R II K AX M EH N S T
RECOMMEND	R EH K AH M EH N D
RECOMMENDATION	R EH K AH M AH N D EY SH AH N
RECOMMENDATIONS	R EH K AH M AH N D EY SH AH N Z
RECOMMENDED	R EH K AH M EH N D AH D
RECOMMENDED(2)	R EH K AH M EH N D IH D
RECOMMENDING	R EH K AH M EH N D IH NG
RECONCILE	R EH K AH N S AY L
RECONCILED	R EH K AH N S AY L D
RECONCILIATION	R EH K AH N S IH L IY EY SH AH N
RECONCILING	R EH K AH N S AY L IH NG
RECORDING	R AH K AO R D IH NG
RECORDING(2)	R IH K AO R D IH NG
RECORDINGS	R IH K AO R D IH NG Z
RECOVER	R IH K AH V ER
RECOVERED	R AH K AH V ER D
RECOVERED(2)	R IH K AH V ER D
RECOVERING	R AH K AH V ER IH NG
RECOVERING(2)	R IH K AH V ER IH NG
RECOVERY	R IH K AH V R IY
RECOVERY(2)	R IH K AH V ER IY
RECREATION	R EH K R IY EY SH AH N
RECTITUDE	R EH K T IH T UW D
RECTOR	R EH K T ER
RECTORY	R EH K T ER IY
RECURRING	R IH K ER IH NG
RECURRING(2)	R IY K ER IH NG
RED	R EH D
REDRESS	R IH D R EH S
REDRESS(2)	R IY D R EH S
REDUCED	R AH D UW S T
REDUCED(2)	R IH D UW S T
REDUCED(3)	R IY D UW S T
REEL	R IY L
REFERENCE	R EH F ER AH N S
REFERENCE(2)	R EH F R AH N S
REFERRED	R AH F ER D
REFERRED(2)	R IH F ER D
REFINEMENTS	R IH F AY N M AH N T S
REFLECT	R AH F L EH K T
REFLECT(2)	R IH F L EH K T
REFLECTED	R AH F L EH K T AH D
REFLECTED(2)	R IH F L EH K T IH D
REFLECTING	R AH F L EH K T IH NG
REFLECTING(2)	R IH F L EH K T IH NG
REFLECTION	R AH F L EH K SH AH N
REFLECTION(2)	R IH F L EH K SH AH N
REFLECTIONS	R IH F L EH K SH AH N Z
REFRAIN	R IH F R EY N
REFRAINED	R IH F R EY N D
REFRESHING	R IH F R EH SH IH NG
REFRESHMENT	R AH F R EH SH M AH N T
REFUGE	R EH F Y UW JH
REFUSAL	R AH F Y UW Z AH L
REFUSAL(2)	R IH F Y UW Z AH L
REFUSALS	R IH F Y UW Z AH L Z
REFUSE	R AH F Y UW Z
REFUSE(2)	R EH F Y UW Z
REFUSE(3)	R IH F Y UW Z
REFUSED	R AH F Y UW Z D
REFUSED(2)	R IH F Y UW Z D
REFUSING	R AH F Y UW Z IH NG
REFUSING(2)	R IH F Y UW Z IH NG
REFUTE	R IH F Y UW T
REGAIN	R IH G EY N
REGAINED	R IY G EY N D
REGARD	R AH G AA R D
REGARD(2)	R IH G AA R D
REGARDED	R AH G AA R D AH D
REGARDED(2)	R IH G AA R D IH D
REGARDING	R AH G AA R D IH NG
REGARDING(2)	R IH G AA R D IH NG
REGARDLESS	R AH G AA R D L AH S
REGIMENT	R EH JH AH M AH N T
REGIMENT'S	R EH JH AH M AH N T S
REGIMENTALS	R EH JH I M EH N T AX L S
REGRET	R AH G R EH T
REGRET(2)	R IH G R EH T
REGRETS	R IH G R EH T S
REGRETTED	R IH G R EH T IH D
REGRETTING	R IH G R EH T IH NG
REGULAR	R EH G Y AH L ER
REGULAR(2)	R EY G Y AH L ER
REGULARLY	R EH G Y AH L ER L IY
REGULARS	R EH G Y AH L ER Z
REGULATE	R EH G Y AH L EY T
REGULATED	R EH G Y AH L EY T AH D
REGULATED(2)	R EH G Y AH L EY T IH D
REGULATION	R EH G Y AH L EY SH AH N
REIN	R EY N
REJECT	R IH JH EH K T
REJECT(2)	R IY JH EH K T
REJECTED	R IH JH EH K T IH D
REJECTED(2)	R IY JH EH K T AH D
REJECTED(3)	R IY JH EH K T IH D
REJECTING	R IH JH EH K T IH NG
REJECTING(2)	R IY JH EH K T IH NG
REJECTION	R IH JH EH K SH AH N
REJECTION(2)	R IY JH EH K SH AH N
REJOICE	R IH JH OY S
REJOICED	R IH JH OY S T
REJOICING	R IH JH OY S IH NG
REJOINED	R IY JH OY N D
RELATE	R IH L EY T
RELATE(2)	R IY L EY T
RELATED	R IH L EY T IH D
RELATED(2)	R IY L EY T AH D
RELATED(3)	R IY L EY T IH D
RELATES	R IH L EY T S
RELATES(2)	R IY L EY T S
RELATING	R IH L EY T IH NG
RELATING(2)	R IY L EY T IH NG
RELATION	R IY L EY SH AH N
RELATIONS	R IY L EY SH AH N Z
RELATIONSHIP	R IY L EY SH AH N SH IH P
RELATIVE	R EH L AH T IH V
RELEASE	R IY L IY S
RELIANCE	R IH L AY AH N S
RELIANCE(2)	R IY L AY AH N S
RELIED	R IH L AY D
RELIED(2)	R IY L AY D
RELIEF	R IH L IY F
RELIEF(2)	R IY L IY F
RELIEVE	R IH L IY V
RELIEVE(2)	R IY L IY V
RELIEVED	R IH L IY V D
RELIEVED(2)	R IY L IY V D
RELINQUISH	R IH L IH NG K W IH SH
RELINQUISH(2)	R IY L IH NG K W IH SH
RELISHED	R EH L IH SH T
RELUCTANCE	R IH L AH K T AH N S
RELUCTANCE(2)	R IY L AH K T AH N S
RELUCTANT	R IH L AH K T AH N T
RELUCTANT(2)	R IY L AH K T AH N T
RELY	R IH L AY
RELY(2)	R IY L AY
REMAIN	R IH M EY N
REMAIN(2)	R IY M EY N
REMAINDER	R IH M EY N D ER
REMAINDER(2)	R IY M EY N D ER
REMAINED	R IH M EY N D
REMAINED(2)	R IY M EY N D
REMAINING	R IH M EY N IH NG
REMAINING(2)	R IY M EY N IH NG
REMAINS	R IH M EY N Z
REMAINS(2)	R IY M EY N Z
REMARK	R IH M AA R K
REMARK(2)	R IY M AA R K
REMARKABLE	R IH M AA R K AH B AH L
REMARKABLE(2)	R IY M AA R K AH B AH L
REMARKABLY	R IH M AA R K AH B L IY
REMARKABLY(2)	R IY M AA R K AH B L IY
REMARKED	R IH M AA R K T
REMARKED(2)	R IY M AA R K T
REMARKS	R IH M AA R K S
REMARKS(2)	R IY M AA R K S
REMEDY	R EH M AH D IY
REMEMBER	R IH M EH M B ER
REMEMBER(2)	R IY M EH M B ER
REMEMBERED	R IH M EH M B ER D
REMEMBERED(2)	R IY M EH M B ER D
REMEMBERING	R IH M EH M B ER IH NG
REMEMBERING(2)	R IY M EH M B ER IH NG
REMEMBERING(3)	R IH M EH M B R IH NG
REMEMBERING(4)	R IY M EH M B R IH NG
REMEMBRANCE	R IY M EH M B R AH N S
REMIND	R IY M AY N D
REMINDED	R IY M AY N D AH D
REMINDED(2)	R IY M AY N D IH D
REMINDING	R IY M AY N D IH NG
REMONSTRANCE	R IH M AA N S T R AH N S
REMORSE	R IH M AO R S
REMOVAL	R IH M UW V AH L
REMOVE	R IY M UW V
REMOVED	R IY M UW V D
REMOVING	R IY M UW V IH NG
RENCONTRE	R IH NG K AA N T AH R
RENDER	R EH N D ER
RENDERED	R EH N D ER D
RENDERING	R EH N D ER IH NG
RENEWAL	R IH N UW AH L
RENEWED	R IH N UW D
RENEWED(2)	R IY N UW D
RENEWING	R IH N UW IH NG
REPAID	R IY P EY D
REPAIRED	R IH P EH R D
REPAIRED(2)	R IY P EH R D
REPEAT	R IH P IY T
REPEAT(2)	R IY P IY T
REPEATED	R IH P IY T IH D
REPEATED(2)	R IY P IY T AH D
REPEATED(3)	R IY P IY T IH D
REPEATEDLY	R IH P IY T IH D L IY
REPEATING	R IH P IY T IH NG
REPEATING(2)	R IY P IY T IH NG
REPEL	R IH P EH L
REPELLED	R AH P EH L D
REPELLED(2)	R IH P EH L D
REPENT	R IH P EH N T
REPENTANCE	R IH P EH N T AH N S
REPENTED	R IH P EH N T IH D
REPETITION	R EH P AH T IH SH AH N
REPINE	R IY P AY N
REPINED	R II P AY N D
REPINING	R IY P AY N IH NG
REPININGS	R II P AY N I ng Z
REPLETE	R IY P L IY T
REPLIED	R IH P L AY D
REPLIED(2)	R IY P L AY D
REPLIES	R IH P L AY Z
REPLIES(2)	R IY P L AY Z
REPLY	R IH P L AY
REPLY(2)	R IY P L AY
REPLYING	R IH P L AY IH NG
REPLYING(2)	R IY P L AY IH NG
REPORT	R IY P AO R T
REPORT(2)	R IH P AO R T
REPORTING	R IY P AO R T IH NG
REPORTING(2)	R IH P AO R T IH NG
REPORTS	R IH P AO R T S
REPORTS(2)	R IY P AO R T S
REPOSE	R IY P OW Z
REPREHENSIBLE	R EH P R IH HH EH N S AH B AH L
REPRESENT	R EH P R AH Z EH N T
REPRESENT(2)	R EH P R IH Z EH N T
REPRESENTATION	R EH P R AH Z EH N T EY SH AH N
REPRESENTED	R EH P R AH Z EH N T AH D
REPRESENTED(2)	R EH P R IH Z EH N T IH D
REPRESENTED(3)	R EH P R AH Z EH N AH D
REPRESENTED(4)	R EH P R IH Z EH N IH D
REPRESENTING	R EH P R IH Z EH N T IH NG
REPRESENTING(2)	R EH P R IH Z EH N IH NG
REPRESS	R IY P R EH S
REPRESSED	R IY P R EH S T
REPRESSING	R IY P R EH S IH NG
REPROACH	R IY P R OW CH
REPROACHED	R IH P R OW CH T
REPROACHES	R IH P R OW CH IH Z
REPROOF	R IY P R UW F
REPROOFS	R IY P R UW F S
REPUGNANCE	R IH P AH G N AH N S
REPUGNANT	R IH P AH G N AH N T
REPUGNANT(2)	R IY P AH G N AH N T
REPULSED	R IY P AH L S T
REPULSIVE	R IY P AH L S IH V
REPUTATION	R EH P Y AH T EY SH AH N
REPUTED	R IH P Y UW T IH D
REPUTED(2)	R IY P Y UW T AH D
REPUTED(3)	R IY P Y UW T IH D
REQUEST	R IH K W EH S T
REQUEST(2)	R IY K W EH S T
REQUESTED	R IH K W EH S T IH D
REQUESTED(2)	R IY K W EH S T AH D
REQUESTED(3)	R IY K W EH S T IH D
REQUESTER	R IH K W EH S T ER
REQUESTING	R IH K W EH S T IH NG
REQUESTING(2)	R IY K W EH S T IH NG
REQUIRE	R IY K W AY ER
REQUIRE(2)	R IY K W AY R
REQUIRE(3)	R IH K W AY ER
REQUIRED	R IY K W AY ER D
REQUIRED(2)	R IY K W AY R D
REQUIRING	R IY K W AY ER IH NG
REQUIRING(2)	R IY K W AY R IH NG
REQUISITE	R EH K W AH Z AH T
REQUITED	R EH K W I T ed
RESCUE	R EH S K Y UW
RESEARCH	R IY S ER CH
RESEMBLANCE	R IH Z EH M B L AH N S
RESEMBLANCE(2)	R IY Z EH M B L AH N S
RESENT	R IH Z EH N T
RESENT(2)	R IY Z EH N T
RESENTED	R IY Z EH N T AH D
RESENTED(2)	R IY Z EH N AH D
RESENTFUL	R IH Z EH N T F AH L
RESENTFULLY	R IH Z EH N T F AH L IY
RESENTMENT	R IH Z EH N T M AH N T
RESENTMENT(2)	R IH Z EH N M AH N T
RESENTMENTS	R IH Z EH N T M AH N T S
RESENTMENTS(2)	R IH Z EH N M AH N T S
RESERVE	R IH Z ER V
RESERVE(2)	R IY Z ER V
RESERVED	R IH Z ER V D
RESERVED(2)	R IY Z ER V D
RESERVES	R IH Z ER V Z
RESERVES(2)	R IY Z ER V Z
RESIDENCE	R EH Z IH D AH N S
RESIDES	R IH Z AY D Z
RESIDES(2)	R IY Z AY D Z
RESIDING	R IH Z AY D IH NG
RESIDING(2)	R IY Z AY D IH NG
RESIGN	R IH Z AY N
RESIGN(2)	R IY Z AY N
RESIGN(3)	R IY S AY N
RESIGNATION	R EH Z AH G N EY SH AH N
RESIGNATION(2)	R EH Z IH G N EY SH AH N
RESIGNED	R IH Z AY N D
RESIGNED(2)	R IY Z AY N D
RESIGNED(3)	R IY S AY N D
RESIGNING	R IH Z AY N IH NG
RESIGNING(2)	R IY Z AY N IH NG
RESIGNING(3)	R IY S AY N IH NG
RESIST	R IH Z IH S T
RESIST(2)	R IY Z IH S T
RESISTANCE	R IH Z IH S T AH N S
RESISTANCE(2)	R IY Z IH S T AH N S
RESISTED	R IH Z IH S T IH D
RESISTED(2)	R IY Z IH S T AH D
RESISTED(3)	R IY Z IH S T IH D
RESISTING	R IH Z IH S T IH NG
RESISTING(2)	R IY Z IH S T IH NG
RESOLUTE	R EH Z AH L UW T
RESOLUTELY	R EH S AH L UW T L IY
RESOLUTELY(2)	R EH Z AH L UW T L IY
RESOLUTION	R EH Z AH L UW SH AH N
RESOLVE	R IY Z AA L V
RESOLVED	R IY Z AA L V D
RESOLVING	R IY Z AA L V IH NG
RESOUNDING	R IY S AW N D IH NG
RESOURCE	R IY S AO R S
RESPECT	R IH S P EH K T
RESPECT(2)	R IY S P EH K T
RESPECTABILITY	R IY S P EH K T AH B IH L IH T IY
RESPECTABLE	R IH S P EH K T AH B AH L
RESPECTABLE(2)	R IY S P EH K T AH B AH L
RESPECTED	R IH S P EH K T IH D
RESPECTED(2)	R IY S P EH K T AH D
RESPECTED(3)	R IY S P EH K T IH D
RESPECTFUL	R IH S P EH K T F AH L
RESPECTING	R IY S P EH K T IH NG
RESPECTIVE	R IH S P EH K T IH V
RESPECTIVE(2)	R IY S P EH K T IH V
RESPECTS	R IH S P EH K T S
RESPECTS(2)	R IY S P EH K T S
RESPECTS(3)	R AH S P EH K S
RESPECTS(4)	R IY S P EH K S
REST	R EH S T
RESTED	R EH S T AH D
RESTED(2)	R EH S T IH D
RESTLESS	R EH S T L AH S
RESTORATION	R EH S T ER EY SH AH N
RESTORED	R IH S T AO R D
RESTORING	R IH S T AO R IH NG
RESTRAIN	R IY S T R EY N
RESTRAINED	R IY S T R EY N D
RESTRAINT	R IH S T R EY N T
RESTRAINT(2)	R IY S T R EY N T
RESULT	R IH Z AH L T
RESULT(2)	R IY Z AH L T
RESUME	R IH Z UW M
RESUME(2)	R IY Z UW M
RESUME(3)	R EH Z AH M EY
RESUMING	R IH Z UW M IH NG
RESUMING(2)	R IY Z UW M IH NG
RETAIL	R IY T EY L
RETAILING	R IY T EY L IH NG
RETAIN	R IH T EY N
RETAIN(2)	R IY T EY N
RETAINED	R IH T EY N D
RETAINED(2)	R IY T EY N D
RETAINING	R IH T EY N IH NG
RETAINING(2)	R IY T EY N IH NG
RETAINS	R IH T EY N Z
RETAINS(2)	R IY T EY N Z
RETALIATE	R IH T AE L IY EY T
RETALIATE(2)	R IY T AE L IY EY T
RETIRED	R IH T AY R D
RETIRED(2)	R IY T AY ER D
RETIRED(3)	R IY T AY R D
RETIREMENT	R IY T AY ER M AH N T
RETIREMENT(2)	R IH T AY ER M AH N T
RETORT	R IY T AO R T
RETREATED	R IY T R IY T AH D
RETREATED(2)	R IY T R IY T IH D
RETREATING	R IY T R IY T IH NG
RETROSPECTIONS	R EH T R OW S P EH K SH axn S
RETROSPECTIVE	R EH T R AH S P EH K T IH V
RETURN	R IH T ER N
RETURN(2)	R IY T ER N
RETURNED	R IH T ER N D
RETURNED(2)	R IY T ER N D
RETURNING	R IH T ER N IH NG
RETURNING(2)	R IY T ER N IH NG
RETURNS	R IH T ER N Z
RETURNS(2)	R IY T ER N Z
REVEALED	R IH V IY L D
REVEALED(2)	R IY V IY L D
REVEALING	R IH V IY L IH NG
REVEALING(2)	R IY V IY L IH NG
REVENGE	R IY V EH N JH
REVENGING	R I V EH N JH I ng
REVERED	R IH V IH R D
REVERIE	R EH V ER IY
REVERSE	R IH V ER S
REVERSE(2)	R IY V ER S
REVERTING	R IH V ER T IH NG
REVIEW	R IY V Y UW
REVIVAL	R IH V AY V AH L
REVIVAL(2)	R IY V AY V AH L
REVIVE	R IH V AY V
REVIVE(2)	R IY V AY V
REVIVED	R IH V AY V D
REVIVED(2)	R IY V AY V D
REVOLT	R IH V OW L T
REVOLT(2)	R IY V OW L T
REVOLTED	R IH V OW L T IH D
REVOLTED(2)	R IY V OW L T AH D
REVOLTED(3)	R IY V OW L T IH D
REVOLUTION	R EH V AH L UW SH AH N
REVOLVING	R IY V AA L V IH NG
REWARDED	R IH W AO R D IH D
REWARDED(2)	R IY W AO R D AH D
REWARDED(3)	R IY W AO R D IH D
REYNOLDS	R EH N AH L D Z
RICH	R IH CH
RICHARD	R IH CH ER D
RICHLY	R IH CH L IY
RID	R IH D
RIDE	R AY D
RIDGE	R IH JH
RIDICULE	R IH D AH K Y UW L
RIDICULING	R IH D AH K Y UW L IH NG
RIDICULOUS	R IH D IH K Y AH L AH S
RIDING	R AY D IH NG
RIGHT	R AY T
RIGHTFUL	R AY T F AH L
RIGHTLY	R AY T L IY
RING	R IH NG
RINGS	R IH NG Z
RISE	R AY Z
RISEN	R IH Z AH N
RISES	R AY Z AH Z
RISES(2)	R AY Z IH Z
RISING	R AY Z IH NG
RISK	R IH S K
RITES	R AY T S
RIVAL	R AY V AH L
RIVALS	R AY V AH L Z
RIVER	R IH V ER
RIVERS	R IH V ER Z
ROAD	R OW D
ROADS	R OW D Z
ROASTED	R OW S T AH D
ROASTED(2)	R OW S T IH D
ROB	R AA B
ROBINSON	R AA B AH N S AH N
ROBINSON'S	R AA B AH N S AH N Z
ROCKS	R AA K S
RODE	R OW D
ROMANTIC	R OW M AE N T IH K
ROOM	R UW M
ROOMS	R UW M Z
ROOTED	R UW T AH D
ROOTED(2)	R UW T IH D
ROSE	R OW Z
ROSES	R OW Z IH Z
ROSINGS	R OW S I ng Z
ROUGH	R AH F
ROUND	R AW N D
ROUSED	R AW Z D
ROUTE	R UW T
ROUTE(2)	R AW T
RUDE	R UW D
RUDENESS	R UW D N AH S
RUIN	R UW AH N
RUIN(2)	R UW IH N
RUINED	R UW AH N D
RUINED(2)	R UW IH N D
RUINING	R UW IH N IH NG
RULE	R UW L
RUN	R AH N
RUNNING	R AH N IH NG
RUNS	R AH N Z
RUSHED	R AH SH T
S	EH S
SACRIFICE	S AE K R AH F AY S
SACRIFICED	S AE K R AH F AY S T
SAD	S AE D
SADLY	S AE D L IY
SAFE	S EY F
SAFELY	S EY F L IY
SAFEST	S EY F AH S T
SAFETY	S EY F T IY
SAGACITY	S AA G AH S IH T IY
SAID	S EH D
SAKE	S EY K
SAKES	S EY K S
SALAD	S AE L AH D
SALLIED	S AE L II D
SALLY	S AE L IY
SALOON	S AH L UW N
SALUTATION	S AE L Y AH T EY SH AH N
SAME	S EY M
SAMENESS	S EY M N AH S
SANCTION	S AE NG K SH AH N
SANCTION(2)	S AE NG SH AH N
SANCTIONED	S AE NG K SH AH N D
SANCTIONED(2)	S AE NG SH AH N D
SANG	S AE NG
SANGUINE	S AE NG G W IH N
SARAH	S EH R AH
SARCASTIC	S AA R K AE S T IH K
SASH	S AE SH
SAT	S AE T
SATIN	S AE T AH N
SATIRICAL	S AH T IH R AH K AH L
SATIRICAL(2)	S AH T IH R IH K AH L
SATISFACTION	S AE T AH S F AE K SH AH N
SATISFACTION(2)	S AE T IH S F AE K SH AH N
SATISFACTIONS	S AE T AH S F AE K SH AH N Z
SATISFACTORY	S AE T AH S F AE K T R IY
SATISFACTORY(2)	S AE T IH S F AE K T ER IY
SATISFIED	S AE T AH S F AY D
SATISFIED(2)	S AE T IH S F AY D
SATISFY	S AE T AH S F AY
SATISFY(2)	S AE T IH S F AY
SATISFYING	S AE T IH S F AY IH NG
SATURDAY	S AE T ER D IY
SATURDAY(2)	S AE T IH D EY
SAUCY	S AO S IY
SAVAGE	S AE V AH JH
SAVAGE(2)	S AE V IH JH
SAVE	S EY V
SAVED	S EY V D
SAVING	S EY V IH NG
SAVOURS	S EY V ER S
SAW	S AO
SAY	S EY
SAYING	S EY IH NG
SAYS	S EH Z
SAYS(2)	S IH Z
SCALE	S K EY L
SCAMPERING	S K AE M P ER IH NG
SCANDALOUS	S K AE N D AH L AH S
SCARBOROUGH	S K AA R B ER OW
SCARCE	S K EH R S
SCARCELY	S K EH R S L IY
SCARCITY	S K EH R S IH T IY
SCARLET	S K AA R L AH T
SCATTERED	S K AE T ER D
SCENE	S IY N
SCENES	S IY N Z
SCHEME	S K IY M
SCHEMES	S K IY M Z
SCHEMING	S K IY M IH NG
SCHOOL	S K UW L
SCIENCE	S AY AH N S
SCOLD	S K OW L D
SCOLDED	S K OW L D AH D
SCOLDED(2)	S K OW L D IH D
SCOLDING	S K OW L D IH NG
SCOPE	S K OW P
SCORE	S K AO R
SCORES	S K AO R Z
SCORN	S K AO R N
SCORNED	S K AO R N D
SCOTCH	S K AA CH
SCOTLAND	S K AA T L AH N D
SCRAPE	S K R EY P
SCREEN	S K R IY N
SCREENS	S K R IY N Z
SCRUPLE	S K R UW P AH L
SCRUPLED	S K R AH P AH L D
SCRUPLES	S K R UW P AH L Z
SCRUPULOUS	S K R UW P Y AH L AH S
SCRUTINY	S K R UW T AH N IY
SE	S AW TH IY S T
SE(2)	S EY
SE(3)	EH S IY
SEA	S IY
SEARCH	S ER CH
SEARCHING	S ER CH IH NG
SEASON	S IY Z AH N
SEASONABLE	S IY Z AH N AH B AH L
SEAT	S IY T
SEATED	S IY T AH D
SEATED(2)	S IY T IH D
SEATS	S IY T S
SECLUDED	S IH K L UW D IH D
SECLUSION	S IH K L UW ZH AH N
SECOND	S EH K AH N D
SECOND(2)	S EH K AH N
SECONDED	S EH K AH N D IH D
SECONDED(2)	S EH K AH N AH D
SECONDING	S EH K axn D I ng
SECONDLY	S EH K AH N D L IY
SECONDLY(2)	S EH K AH N L IY
SECRECY	S IY K R AH S IY
SECRET	S IY K R AH T
SECRET(2)	S IY K R IH T
SECRETLY	S IY K R IH T L IY
SECRETS	S IY K R AH T S
SECRETS(2)	S IY K R IH T S
SECURE	S IH K Y UH R
SECURED	S IH K Y UH R D
SECURITY	S IH K Y UH R AH T IY
SEDATE	S IH D EY T
SEDATENESS	S IH D EY T N AH S
SEDUCTION	S IH D AH K SH AH N
SEE	S IY
SEEING	S IY IH NG
SEEK	S IY K
SEEKING	S IY K IH NG
SEEM	S IY M
SEEMED	S IY M D
SEEMING	S IY M IH NG
SEEMS	S IY M Z
SEEN	S IY N
SEES	S IY Z
SEIZE	S IY Z
SEIZED	S IY Z D
SEIZING	S IY Z IH NG
SELDOM	S EH L D AH M
SELECTED	S AH L EH K T AH D
SELECTED(2)	S AH L EH K T IH D
SELECTING	S AH L EH K T IH NG
SELF	S EH L F
SELFISH	S EH L F IH SH
SELFISHNESS	S EH L F IH SH N AH S
SELL	S EH L
SELVES	S EH L V Z
SEMINARIES	S EH M AH N EH R IY Z
SEND	S EH N D
SENDING	S EH N D IH NG
SENDS	S EH N D Z
SENIORITY	S IY N Y AO R IH T IY
SENSATION	S EH N S EY SH AH N
SENSATIONS	S EH N S EY SH AH N Z
SENSE	S EH N S
SENSES	S EH N S IH Z
SENSIBILITY	S EH N S IH B IH L IH T IY
SENSIBLE	S EH N S AH B AH L
SENSIBLY	S EH N S AH B L IY
SENT	S EH N T
SENTENCE	S EH N T AH N S
SENTENCES	S EH N T AH N S AH Z
SENTENCES(2)	S EH N T AH N S IH Z
SENTIMENT	S EH N T AH M AH N T
SENTIMENT(2)	S EH N AH M AH N T
SENTIMENTS	S EH N T AH M AH N T S
SENTIMENTS(2)	S EH N AH M AH N T S
SENTINEL	S EH N T AH N AH L
SEPARATE	S EH P ER EY T
SEPARATE(2)	S EH P ER IH T
SEPARATE(3)	S EH P R AH T
SEPARATED	S EH P ER EY T AH D
SEPARATED(2)	S EH P ER EY T IH D
SEPARATELY	S EH P ER AH T L IY
SEPARATELY(2)	S EH P R AH T L IY
SEPARATES	S EH P ER EY T S
SEPARATES(2)	S EH P ER IH T S
SEPARATING	S EH P ER EY T IH NG
SEPARATION	S EH P ER EY SH AH N
SEPT	S EH P T
SEPTEMBER	S EH P T EH M B ER
SEQUEL	S IY K W AH L
SERENITY	S ER EH N AH T IY
SERIOUS	S IH R IY AH S
SERIOUSLY	S IH R IY AH S L IY
SERMON	S ER M AH N
SERMONS	S ER M AH N Z
SERVANT	S ER V AH N T
SERVANT'S	S ER V AH N T S
SERVANTS	S ER V AH N T S
SERVE	S ER V
SERVICE	S ER V AH S
SERVICE(2)	S ER V IH S
SERVICEABLE	S ER V AH S AH B AH L
SERVICES	S ER V AH S AH Z
SERVICES(2)	S ER V IH S IH Z
SERVILITY	S ER V I L I T II
SERVING	S ER V IH NG
SET	S EH T
SETTING	S EH T IH NG
SETTLE	S EH T AH L
SETTLED	S EH T AH L D
SETTLEMENT	S EH T AH L M AH N T
SETTLEMENTS	S EH T AH L M AH N T S
SETTLING	S EH T AH L IH NG
SETTLING(2)	S EH T L IH NG
SEVEN	S EH V AH N
SEVERAL	S EH V R AH L
SEVERAL(2)	S EH V ER AH L
SEVERE	S AH V IH R
SEVEREST	S AH V IH R AH S T
SEVERITY	S IH V EH R IH T IY
SEX	S EH K S
SHADE	SH EY D
SHADES	SH EY D Z
SHAKE	SH EY K
SHAKEN	SH EY K AH N
SHAKING	SH EY K IH NG
SHALL	SH AE L
SHAME	SH EY M
SHAMEFUL	SH EY M F AH L
SHAMELESS	SH EY M L AH S
SHAN	SH AE N
SHAPE	SH EY P
SHARE	SH EH R
SHARED	SH EH R D
SHARERS	SH EH R ER S
SHARING	SH EH R IH NG
SHARP	SH AA R P
SHARPENED	SH AA R P AH N D
SHE	SH IY
SHED	SH EH D
SHEET	SH IY T
SHEETS	SH IY T S
SHELTERED	SH EH L T ER D
SHELVES	SH EH L V Z
SHEW	SH UW
SHEWED	SH UW D
SHIELD	SH IY L D
SHIFT	SH IH F T
SHIFTING	SH IH F T IH NG
SHILLINGS	SH IH L IH NG Z
SHINE	SH AY N
SHIRE	SH AY R
SHOCK	SH AA K
SHOCKED	SH AA K T
SHOCKING	SH AA K IH NG
SHOE	SH UW
SHOES	SH UW Z
SHOOK	SH UH K
SHOOT	SH UW T
SHOOTING	SH UW T IH NG
SHOP	SH AA P
SHOPPING	SH AA P IH NG
SHOPS	SH AA P S
SHORT	SH AO R T
SHORTEN	SH AO R T AH N
SHORTER	SH AO R T ER
SHORTLY	SH AO R T L IY
SHORTNESS	SH AO R T N AH S
SHOULD	SH UH D
SHOULDERS	SH OW L D ER Z
SHOW	SH OW
SHOWED	SH OW D
SHOWING	SH OW IH NG
SHOWN	SH OW N
SHOWS	SH OW Z
SHREWISH	SH R EH W I SH
SHRINK	SH R IH NG K
SHRUBBERY	SH R AH B ER IY
SHRUG	SH R AH G
SHUT	SH AH T
SHY	SH AY
SHYNESS	SH AY N AH S
SICK	S IH K
SICKLY	S IH K L IY
SIDE	S AY D
SIDEBOARD	S AY D B OW R D
SIDES	S AY D Z
SIGH	S AY
SIGHED	S AY D
SIGHT	S AY T
SIGHTED	S AY T AH D
SIGHTED(2)	S AY T IH D
SIGN	S AY N
SIGNAL	S IH G N AH L
SIGNIFICANT	S AH G N IH F IH K AH N T
SIGNIFICANT(2)	S IH G N IH F IH K AH N T
SIGNIFY	S IH G N AH F AY
SIGNS	S AY N Z
SILENCE	S AY L AH N S
SILENCED	S AY L AH N S T
SILENT	S AY L AH N T
SILENTLY	S AY L AH N T L IY
SILLIEST	S IH L IY AH S T
SILLY	S IH L IY
SIMILAR	S IH M AH L ER
SIMILARITY	S IH M AH L EH R AH T IY
SIMPERED	S IH M P IY R D
SIMPERS	S I M P ER S
SIMPLE	S IH M P AH L
SIMPLETON	S IH M P AH L T AH N
SIMPLY	S IH M P L IY
SINCE	S IH N S
SINCERE	S IH N S IH R
SINCERELY	S IH N S IH R L IY
SINCERITY	S IH N S EH R AH T IY
SING	S IH NG
SINGING	S IH NG IH NG
SINGLE	S IH NG G AH L
SINGLED	S IH NG G AH L D
SINGLING	S IH NG G AH L IH NG
SINGLING(2)	S IH NG G L IH NG
SINGS	S IH NG Z
SINGULAR	S IH NG G Y AH L ER
SINK	S IH NG K
SINKING	S IH NG K IH NG
SIR	S ER
SISTER	S IH S T ER
SISTER'S	S IH S T ER Z
SISTERLY	S IH S T ER L IY
SISTERS	S IH S T ER Z
SIT	S IH T
SITTING	S IH T IH NG
SITUATED	S IH CH UW EY T IH D
SITUATION	S IH CH UW EY SH AH N
SIX	S IH K S
SIXPENCE	S IH K S AH N S
SIXTEEN	S IH K S T IY N
SIXTH	S IH K S TH
SIZE	S AY Z
SIZED	S AY Z D
SKETCH	S K EH CH
SKILL	S K IH L
SLACKEN	S L AE K AH N
SLAVE	S L EY V
SLEEP	S L IY P
SLEEPING	S L IY P IH NG
SLEEPLESS	S L IY P L AH S
SLEEVES	S L IY V Z
SLEPT	S L EH P T
SLIGHT	S L AY T
SLIGHTED	S L AY T IH D
SLIGHTEST	S L AY T AH S T
SLIGHTINGLY	S L AY T IH NG L IY
SLIGHTLY	S L AY T L IY
SLIT	S L IH T
SLOPING	S L OW P IH NG
SLOW	S L OW
SLOWLY	S L OW L IY
SLY	S L AY
SLYNESS	S L AY N AH S
SMALL	S M AO L
SMALLEST	S M AO L AH S T
SMART	S M AA R T
SMILE	S M AY L
SMILED	S M AY L D
SMILES	S M AY L Z
SMILING	S M AY L IH NG
SMILINGLY	S M AY L IH NG L IY
SMIRKS	S M ER K S
SMOOTHLY	S M UW DH L IY
SNEER	S N IH R
SNEERING	S N IH R IH NG
SNUG	S N AH G
SO	S OW
SOCIAL	S OW SH AH L
SOCIETIES	S AH S AY AH T IY Z
SOCIETY	S AH S AY AH T IY
SOFAS	S OW F AH Z
SOFTENED	S AO F AH N D
SOFTNESS	S AO F T N AH S
SOFTNESS(2)	S AO F N AH S
SOLACE	S AA L AH S
SOLACE(2)	S OW L IH S
SOLACED	S OW L EY S T
SOLDIERS	S OW L JH ER Z
SOLE	S OW L
SOLELY	S OW L L IY
SOLEMN	S AA L AH M
SOLEMNITY	S AH L EH M N AH T IY
SOLICIT	S AH L IH S IH T
SOLICITATION	S AH L IH S IH T EY SH AH N
SOLICITING	S AH L IH S AH T IH NG
SOLICITUDE	S AH L IH S IH T UW D
SOLID	S AA L AH D
SOLIDITY	S AH L IH D AH T IY
SOLITARY	S AA L AH T EH R IY
SOLITUDE	S AA L AH T UW D
SOME	S AH M
SOMEBODY	S AH M B AA D IY
SOMEBODY(2)	S AH M B AH D IY
SOMEHOW	S AH M HH AW
SOMEONE	S AH M W AH N
SOMETHING	S AH M TH IH NG
SOMETIMES	S AH M T AY M Z
SOMEWHAT	S AH M W AH T
SOMEWHAT(2)	S AH M HH W AH T
SOMEWHERE	S AH M W EH R
SON	S AH N
SONG	S AO NG
SONGS	S AO NG Z
SONNET	S AA N IH T
SONS	S AH N Z
SOON	S UW N
SOONER	S UW N ER
SOOTHE	S UW DH
SOOTHED	S UW DH D
SORE	S AO R
SORELY	S AO R L IY
SORROW	S AA R OW
SORRY	S AA R IY
SORT	S AO R T
SOUGHT	S AO T
SOUL	S OW L
SOUND	S AW N D
SOUNDS	S AW N D Z
SOUNDS(2)	S AW N Z
SOUP	S UW P
SOUR	S AW ER
SOUR(2)	S AW R
SOURCE	S AO R S
SOURCES	S AO R S AH Z
SOUTH	S AW TH
SPACE	S P EY S
SPACIOUS	S P EY SH AH S
SPANISH	S P AE N IH SH
SPARE	S P EH R
SPARED	S P EH R D
SPARKLED	S P AA R K AH L D
SPARS	S P AA R Z
SPASMS	S P AE Z AH M Z
SPEAK	S P IY K
SPEAKER	S P IY K ER
SPEAKING	S P IY K IH NG
SPEAKS	S P IY K S
SPECIAL	S P EH SH AH L
SPECULATION	S P EH K Y AH L EY SH AH N
SPEECH	S P IY CH
SPEECHES	S P IY CH AH Z
SPEECHES(2)	S P IY CH IH Z
SPEED	S P IY D
SPEEDIEST	S P II D I EH S T
SPEEDILY	S P IY D AH L IY
SPEEDY	S P IY D IY
SPEND	S P EH N D
SPENDING	S P EH N D IH NG
SPENT	S P EH N T
SPHERE	S F IH R
SPIRIT	S P IH R AH T
SPIRIT(2)	S P IH R IH T
SPIRITED	S P IH R AH T AH D
SPIRITED(2)	S P IH R IH T IH D
SPIRITLESS	S P IH R AH T L AH S
SPIRITS	S P IH R AH T S
SPIRITS(2)	S P IH R IH T S
SPITE	S P AY T
SPITEFUL	S P AY T F AH L
SPLEEN	S P L IY N
SPLENDID	S P L EH N D AH D
SPLENDID(2)	S P L EH N D IH D
SPLENDOUR	S P L EH N D AH R
SPOILT	S P OY L T
SPOKE	S P OW K
SPOKEN	S P OW K AH N
SPOKESMAN	S P OW K S M AH N
SPORT	S P AO R T
SPORTIVE	S P OW R T I V
SPORTS	S P AO R T S
SPORTSMEN	S P AO R T S M IH N
SPOT	S P AA T
SPOTS	S P AA T S
SPRAINED	S P R EY N D
SPRANG	S P R AE NG
SPREAD	S P R EH D
SPREADING	S P R EH D IH NG
SPRING	S P R IH NG
SPRING(2)	S P ER IH NG
SPRINGING	S P R IH NG IH NG
SPRINGS	S P R IH NG Z
SPRINGS(2)	S P ER IH NG Z
SPUR	S P ER
SPURNED	S P ER N D
SQUEAMISH	S K W IY M IH SH
ST	S T R IY T
ST(2)	S EY N T
STABILITY	S T AH B IH L IH T IY
STABLES	S T EY B AH L Z
STAGE	S T EY JH
STAGGERED	S T AE G ER D
STAID	S T EY D
STAIRCASE	S T EH R K EY S
STAIRS	S T EH R Z
STAMP	S T AE M P
STAND	S T AE N D
STANDING	S T AE N D IH NG
STANDS	S T AE N D Z
STANZAS	S T AE N Z AH Z
STARED	S T EH R D
START	S T AA R T
STARTED	S T AA R T AH D
STARTED(2)	S T AA R T IH D
STARTING	S T AA R T IH NG
STARTLED	S T AA R T AH L D
STARVE	S T AA R V
STATE	S T EY T
STATED	S T EY T AH D
STATED(2)	S T EY T IH D
STATELINESS	S T EY T L I N EH S
STATELY	S T EY T L IY
STATEMENT	S T EY T M AH N T
STATING	S T EY T IH NG
STATION	S T EY SH AH N
STATIONED	S T EY SH AH N D
STAY	S T EY
STAYED	S T EY D
STAYING	S T EY IH NG
STAYS	S T EY Z
STEADFAST	S T EH D F AE S T
STEADFASTLY	S T EH D F AE S T L IY
STEADILY	S T EH D AH L IY
STEADINESS	S T EH D IY N IH S
STEADY	S T EH D IY
STEM	S T EH M
STEP	S T EH P
STEPPED	S T EH P T
STEPPING	S T EH P IH NG
STEPS	S T EH P S
STEWARD	S T UW ER D
STIFFLY	S T IH F L IY
STIFFNESS	S T IH F N AH S
STILES	S T AY L Z
STILL	S T IH L
STIR	S T ER
STIRRING	S T ER IH NG
STIRS	S T ER Z
STOCKINGS	S T AA K IH NG Z
STOKE	S T OW K
STOLE	S T OW L
STONE	S T OW N
STOOD	S T UH D
STOP	S T AA P
STOPPED	S T AA P T
STOPPING	S T AA P IH NG
STORE	S T AO R
STORING	S T AO R IH NG
STORM	S T AO R M
STORY	S T AO R IY
STOUT	S T AW T
STOUTLY	S T AW T L IY
STRANGE	S T R EY N JH
STRANGELY	S T R EY N JH L IY
STRANGENESS	S T R EY N JH N AH S
STRANGER	S T R EY N JH ER
STRANGER'S	S T R EY N JH ER Z
STRANGERS	S T R EY N JH ER Z
STRATAGEMS	S T R AE T AH JH AH M Z
STRAWS	S T R AO Z
STREAM	S T R IY M
STREET	S T R IY T
STREETS	S T R IY T S
STRENGTH	S T R EH NG K TH
STRENGTH(2)	S T R EH NG TH
STRENUOUSLY	S T R EH N Y UW AH S L IY
STRESS	S T R EH S
STRETCH	S T R EH CH
STRETCHED	S T R EH CH T
STRETCHING	S T R EH CH IH NG
STRICTEST	S T R IH K T AH S T
STRICTLY	S T R IH K T L IY
STRICTURES	S T R IH K CH ER Z
STRIKE	S T R AY K
STRIKING	S T R AY K IH NG
STRIKINGLY	S T R AY K IH NG L IY
STRIVING	S T R AY V IH NG
STROKE	S T R OW K
STROLL	S T R OW L
STRONG	S T R AO NG
STRONGER	S T R AO NG ER
STRONGER(2)	S T R AO NG G ER
STRONGEST	S T R AO NG G AH S T
STRONGLY	S T R AO NG L IY
STRUCK	S T R AH K
STRUGGLE	S T R AH G AH L
STRUGGLED	S T R AH G AH L D
STRUGGLES	S T R AH G AH L Z
STRUGGLING	S T R AH G AH L IH NG
STRUGGLING(2)	S T R AH G L IH NG
STUBBORNNESS	S T AH B ER N N AH S
STUBBORNNESS(2)	S T AH B ER N AH S
STUDIED	S T AH D IY D
STUDIER	S T AX D I ER
STUDIES	S T AH D IY Z
STUDIOUS	S T UW D IY AH S
STUDY	S T AH D IY
STUDYING	S T AH D IY IH NG
STUFFY	S T AH F IY
STUMBLING	S T AH M B AH L IH NG
STUMBLING(2)	S T AH M B L IH NG
STUPID	S T UW P AH D
STUPID(2)	S T UW P IH D
STUPIDER	S T UW P AH D ER
STUPIDITY	S T UW P IH D IH T IY
STYLE	S T AY L
SUBJECT	S AH B JH EH K T
SUBJECT(2)	S AH B JH IH K T
SUBJECTION	S AH B JH IH K SH AH N
SUBJECTS	S AH B JH IH K T S
SUBJECTS(2)	S AH B JH EH K T S
SUBJECTS(3)	S AH B JH EH K S
SUBJOIN	S AX B JH OY N
SUBMIT	S AH B M IH T
SUBMITTED	S AH B M IH T AH D
SUBSEQUENT	S AH B S AH K W AH N T
SUBSIDED	S AH B S AY D IH D
SUBSIST	S AH B S IH S T
SUBSISTED	S AH B S IH S T IH D
SUBSISTING	S AH B S IH S T IH NG
SUBSTANCE	S AH B S T AH N S
SUBSTANTIAL	S AH B S T AE N CH AH L
SUBSTANTIAL(2)	S AH B S T AE N SH AH L
SUBSTITUTE	S AH B S T AH T UW T
SUCCEED	S AH K S IY D
SUCCEEDED	S AH K S IY D AH D
SUCCEEDED(2)	S AH K S IY D IH D
SUCCEEDING	S AH K S IY D IH NG
SUCCEEDS	S AH K S IY D Z
SUCCESS	S AH K S EH S
SUCCESSFUL	S AH K S EH S F AH L
SUCCESSFULLY	S AH K S EH S F AH L IY
SUCCESSION	S AH K S EH SH AH N
SUCCESSIVELY	S AH K S EH S IH V L IY
SUCCESSOR	S AH K S EH S ER
SUCH	S AH CH
SUDDEN	S AH D AH N
SUDDENLY	S AH D AH N L IY
SUDDENNESS	S AH D AH N N AH S
SUFFER	S AH F ER
SUFFERED	S AH F ER D
SUFFERER	S AH F ER ER
SUFFERING	S AH F ER IH NG
SUFFERING(2)	S AH F R IH NG
SUFFERINGS	S AH F ER IH NG Z
SUFFERINGS(2)	S AH F R IH NG Z
SUFFERS	S AH F ER Z
SUFFICIENCY	S AH F IH SH AH N S IY
SUFFICIENT	S AH F IH SH AH N T
SUFFICIENTLY	S AH F IH SH AH N T L IY
SUGGEST	S AH G JH EH S T
SUGGESTED	S AH G JH EH S T AH D
SUGGESTED(2)	S AH G JH EH S T IH D
SUGGESTING	S AH G JH EH S T IH NG
SUGGESTION	S AH G JH EH S CH AH N
SUIT	S UW T
SUITABLE	S UW T AH B AH L
SUITABLENESS	S W IY T AH B AH L N AH S
SUITED	S UW T AH D
SUITED(2)	S UW T IH D
SUITING	S UW T IH NG
SUM	S AH M
SUMMER	S AH M ER
SUMMON	S AH M AH N
SUMMONED	S AH M AH N D
SUMMONS	S AH M AH N Z
SUNDAY	S AH N D EY
SUNDAY(2)	S AH N D IY
SUNK	S AH NG K
SUPER	S UW P ER
SUPERCILIOUS	S UW P ER S IH L IY AH S
SUPERCILIOUSNESS	S OO P ER S I L I AX S N EH S
SUPERINTENDED	S OO P ER I N T EH N D ed
SUPERINTENDENCE	S OO P ER I N T EH N D EH N S
SUPERINTENDS	S OO P ER I N T EH N D Z
SUPERIOR	S UW P IH R IY ER
SUPERIORITY	S UW P IH R IY AO R IH T IY
SUPERLATIVELY	S OO P ER L EY T I V L II
SUPERSEDED	S UW P ER S IY D AH D
SUPPER	S AH P ER
SUPPLICATION	S AH P L AH K EY SH AH N
SUPPLIED	S AH P L AY D
SUPPLY	S AH P L AY
SUPPLYING	S AH P L AY IH NG
SUPPORT	S AH P AO R T
SUPPORTED	S AH P AO R T AH D
SUPPORTED(2)	S AH P AO R T IH D
SUPPOSE	S AH P OW Z
SUPPOSED	S AH P OW Z D
SUPPOSING	S AH P OW Z IH NG
SUPPOSITION	S AH P AH Z IH SH AH N
SUPPOSITIONS	S AH P AH Z IH SH AH N Z
SUPPRESS	S AH P R EH S
SUPPRESSED	S AH P R EH S T
SURE	SH UH R
SURELY	SH UH R L IY
SUREST	SH UH R IH S T
SURMISE	S ER M AY Z
SURMISES	S ER M AY Z IH Z
SURMOUNT	S ER M AW N T
SURPASS	S ER P AE S
SURPASSING	S ER P AE S IH NG
SURPRISE	S ER P R AY Z
SURPRISE(2)	S AH P R AY Z
SURPRISED	S ER P R AY Z D
SURPRISED(2)	S AH P R AY Z D
SURROUNDED	S ER AW N D AH D
SURROUNDED(2)	S ER AW N D IH D
SURROUNDING	S ER AW N D IH NG
SURVEY	S ER V EY
SURVEYING	S ER V EY IH NG
SURVIVE	S ER V AY V
SURVIVED	S ER V AY V D
SURVIVOR	S ER V AY V ER
SUSCEPTIBILITY	S AH S EH P T AH B IH L AH T IY
SUSPECT	S AH S P EH K T
SUSPECTED	S AH S P EH K T AH D
SUSPECTED(2)	S AH S P EH K T IH D
SUSPECTING	S AH S P EH K T IH NG
SUSPECTS	S AH S P EH K T S
SUSPECTS(2)	S AH S P EH K S
SUSPEND	S AH S P EH N D
SUSPENDED	S AH S P EH N D AH D
SUSPENDED(2)	S AH S P EH N D IH D
SUSPENSE	S AH S P EH N S
SUSPICION	S AH S P IH SH AH N
SUSPICIONS	S AH S P IH SH AH N Z
SUSPICIOUS	S AH S P IH SH AH S
SUSTAINED	S AH S T EY N D
SWALLOWED	S W AA L OW D
SWEET	S W IY T
SWEETEST	S W IY T AH S T
SWEETNESS	S W IY T N AH S
SWELL	S W EH L
SWELLED	S W EH L D
SWELLING	S W EH L IH NG
SYLLABLE	S IH L AH B AH L
SYLLABLES	S IH L AH B AH L Z
SYMMETRY	S IH M AH T R IY
SYMPATHISE	S IH M P AH TH AY Z
SYMPTOM	S IH M P T AH M
SYMPTOMS	S IH M P T AH M Z
SYNONYMOUSLY	S AH N AA N AH M AH S L IY
T	T IY
TABLE	T EY B AH L
TABLES	T EY B AH L Z
TACIT	T AE S IH T
TACITURN	T AE S IH T ER N
TACKLE	T AE K AH L
TAKE	T EY K
TAKEN	T EY K AH N
TAKES	T EY K S
TAKING	T EY K IH NG
TALENT	T AE L AH N T
TALENTS	T AE L AH N T S
TALK	T AO K
TALKED	T AO K T
TALKER	T AO K ER
TALKING	T AO K IH NG
TALKS	T AO K S
TALL	T AO L
TALLER	T AO L ER
TALLEST	T AO L IH S T
TANNED	T AE N D
TASTE	T EY S T
TASTES	T EY S T S
TAUGHT	T AO T
TAX	T AE K S
TEA	T IY
TEACH	T IY CH
TEACHING	T IY CH IH NG
TEAR	T EH R
TEAR(2)	T IH R
TEARS	T EH R Z
TEARS(2)	T IH R Z
TEASE	T IY Z
TEASED	T IY Z D
TEASING	T IY Z IH NG
TEDIOUS	T IY D IY AH S
TEETH	T IY TH
TELL	T EH L
TELLING	T EH L IH NG
TELLS	T EH L Z
TEMPER	T EH M P ER
TEMPERED	T EH M P ER D
TEMPERS	T EH M P ER Z
TEMPORARY	T EH M P ER EH R IY
TEMPT	T EH M P T
TEMPTATION	T EH M T EY SH AH N
TEMPTATIONS	T EH M T EY SH AH N Z
TEMPTED	T EH M P T AH D
TEMPTED(2)	T EH M P T IH D
TEN	T EH N
TENANT	T EH N AH N T
TENANTS	T EH N AH N T S
TEND	T EH N D
TENDENCY	T EH N D AH N S IY
TENDER	T EH N D ER
TENDERLY	T EH N D ER L IY
TENDERNESS	T EH N D ER N AH S
TENOR	T EH N ER
TENS	T EH N Z
TENT	T EH N T
TENTS	T EH N T S
TERM	T ER M
TERMED	T ER M D
TERMINATION	T ER M AH N EY SH AH N
TERMS	T ER M Z
TERRIFIC	T ER IH F IH K
TEST	T EH S T
TESTIFIED	T EH S T AH F AY D
TESTIFYING	T EH S T AH F AY IH NG
TESTIMONY	T EH S T AH M OW N IY
TETE	T EH T
THAN	DH AE N
THAN(2)	DH AH N
THANK	TH AE NG K
THANKED	TH AE NG K T
THANKFUL	TH AE NG K F AH L
THANKFULLY	TH AE NG K F AH L IY
THANKFULNESS	TH AE NG K F AH L N AH S
THANKING	TH AE NG K IH NG
THANKS	TH AE NG K S
THAT	DH AE T
THAT(2)	DH AH T
THE	DH AH
THE(2)	DH IY
THEATRE	TH IY AH T ER
THEATRES	TH IY AH T ER Z
THEIR	DH EH R
THEIRS	DH EH R Z
THEM	DH EH M
THEM(2)	DH AH M
THEMSELVES	DH EH M S EH L V Z
THEMSELVES(2)	DH AH M S EH L V Z
THEN	DH EH N
THENCE	DH EH N S
THERE	DH EH R
THERE'S	DH EH R Z
THEREBY	DH EH R B AY
THEREFORE	DH EH R F AO R
THEREIN	DH EH R IH N
THEREUPON	DH EH R AH P AA N
THESE	DH IY Z
THEY	DH EY
THIN	TH IH N
THING	TH IH NG
THINGS	TH IH NG Z
THINK	TH IH NG K
THINKING	TH IH NG K IH NG
THINKS	TH IH NG K S
THIRD	TH ER D
THIRDLY	TH ER D L IY
THIRTEEN	TH ER T IY N
THIRTY	TH ER D IY
THIRTY(2)	TH ER T IY
THIS	DH IH S
THITHER	TH IH DH ER
THOROUGH	TH ER OW
THOROUGH(2)	TH AO R OW
THOROUGHLY	TH ER OW L IY
THOSE	DH OW Z
THOUGH	DH OW
THOUGHT	TH AO T
THOUGHTFUL	TH AO T F AH L
THOUGHTFULNESS	TH AO T F AH L N IH S
THOUGHTLESS	TH AO T L AH S
THOUGHTLESSNESS	TH AO T L AH S N AH S
THOUGHTS	TH AO T S
THOUSAND	TH AW Z AH N D
THOUSAND(2)	TH AW Z AH N
THREADBARE	TH R EH D B EH R
THREATENED	TH R EH T AH N D
THREATS	TH R EH T S
THREE	TH R IY
THREW	TH R UW
THROAT	TH R OW T
THROUGH	TH R UW
THROUGHOUT	TH R UW AW T
THROW	TH R OW
THROWING	TH R OW IH NG
THROWN	TH R OW N
THURSDAY	TH ER Z D EY
THURSDAY(2)	TH ER Z D IY
THUS	DH AH S
THWARTED	TH W AO R T AH D
THWARTED(2)	TH W AO R T IH D
TICKETS	T IH K AH T S
TICKETS(2)	T IH K IH T S
TIDE	T AY D
TIDINGS	T AY D IH NG Z
TILL	T IH L
TIME	T AY M
TIMED	T AY M D
TIMES	T AY M Z
TIRED	T AY ER D
TIRES	T AY ER Z
TIRESOME	T AY ER S AH M
TIS	T IH Z
TITHES	T AY DH Z
TITLE	T AY T AH L
TO	T UW
TO(2)	T IH
TO(3)	T AH
TOGETHER	T AH G EH DH ER
TOILETTE	T OY L EH T
TOKEN	T OW K AH N
TOLD	T OW L D
TOLERABLE	T AA L ER AH B AH L
TOLERABLY	T AA L ER AH B L IY
TONE	T OW N
TONGUE	T AH NG
TONGUES	T AH NG Z
TOO	T UW
TOOK	T UH K
TOP	T AA P
TOP(2)	T AO P
TOPIC	T AA P IH K
TOPICS	T AA P IH K S
TORMENT	T AO R M EH N T
TORMENTING	T AO R M EH N T IH NG
TORTURED	T AO R CH ER D
TOTAL	T OW T AH L
TOTALLY	T OW T AH L IY
TOUCHED	T AH CH T
TOUR	T UH R
TOWARD	T AH W AO R D
TOWARD(2)	T AO R D
TOWARDS	T AH W AO R D Z
TOWARDS(2)	T AO R D Z
TOWN	T AW N
TRACE	T R EY S
TRACED	T R EY S T
TRACES	T R EY S AH Z
TRACES(2)	T R EY S IH Z
TRACTABLE	T R AE K T AH B AH L
TRADE	T R EY D
TRADESMAN	T R EY D Z M AE N
TRADESMAN'S	T R EY D Z M axn S
TRAIN	T R EY N
TRAIT	T R EY T
TRANQUIL	T R AE NG K W AH L
TRANQUIL(2)	T R AE NG K W IH L
TRANQUILLITY	T R AE N K W IH L AH T IY
TRANQUILLY	T R AE ng K W I L II
TRANSACTIONS	T R AE N Z AE K SH AH N Z
TRANSFERRED	T R AE N S F ER D
TRANSIENT	T R AE N ZH AH N T
TRANSITION	T R AE N Z IH SH AH N
TRANSPIRED	T R AE N S P AY ER D
TRANSPORT	T R AE N S P AO R T
TRANSPORTS	T R AE N S P AO R T S
TRAVELLED	T R AE V AH L D
TRAVELLERS	T R AE V AH L ER Z
TRAVELLING	T R AE V AH L IH NG
TRAVELLING(2)	T R AE V L IH NG
TREASURE	T R EH ZH ER
TREASURED	T R EH ZH ER D
TREAT	T R IY T
TREATED	T R IY T AH D
TREATED(2)	T R IY T IH D
TREATING	T R IY T IH NG
TREATMENT	T R IY T M AH N T
TREES	T R IY Z
TREMBLE	T R EH M B AH L
TREMBLED	T R EH M B AH L D
TREMBLING	T R EH M B AH L IH NG
TREMBLING(2)	T R EH M B L IH NG
TREMBLINGS	T R EH M B AH L IH NG Z
TREPIDATION	T R EH P IH D EY SH AH N
TRESPASS	T R EH S P AE S
TRESPASS(2)	T R EH S P AH S
TRIAL	T R AY AH L
TRIAL(2)	T R AY L
TRIALS	T R AY AH L Z
TRIALS(2)	T R AY L Z
TRIBUTE	T R IH B Y UW T
TRICKS	T R IH K S
TRIED	T R AY D
TRIES	T R AY Z
TRIFLE	T R AY F AH L
TRIFLED	T R AY F AH L D
TRIFLING	T R AY F L IH NG
TRIM	T R IH M
TRIMMING	T R IH M IH NG
TRIUMPH	T R AY AH M F
TRIUMPHANT	T R AY AH M F AH N T
TRIUMPHANTLY	T R AY AH M F AH N T L IY
TRIUMPHING	T R AY AH M F IH NG
TROOP	T R UW P
TROUBLE	T R AH B AH L
TROUBLESOME	T R AH B AH L S AH M
TROUBLING	T R AH B AH L IH NG
TROUBLING(2)	T R AH B L IH NG
TROUT	T R AW T
TRUE	T R UW
TRUEST	T R UW IH S T
TRULY	T R UW L IY
TRUNK	T R AH NG K
TRUNKS	T R AH NG K S
TRUST	T R AH S T
TRUSTED	T R AH S T IH D
TRUSTING	T R AH S T IH NG
TRUTH	T R UW TH
TRY	T R AY
TRYING	T R AY IH NG
TRYING(2)	T R AY NG
TUESDAY	T UW Z D IY
TUESDAY(2)	T UW Z D EY
TUESDAY(3)	T Y UW Z D EY
TUMULT	T UW M AH L T
TURN	T ER N
TURNED	T ER N D
TURNING	T ER N IH NG
TURNPIKE	T ER N P AY K
TURNPIKES	T ER N P AY K S
TURNS	T ER N Z
TWELVE	T W EH L V
TWELVEMONTH	T W EH L V M AH N TH
TWELVEMONTH'S	T W EH L V M axn TH S
TWENTY	T W EH N T IY
TWENTY(2)	T W EH N IY
TWICE	T W AY S
TWO	T UW
UGLIER	AH G L IY ER
UGLY	AH G L IY
ULTIMATELY	AH L T AH M AH T L IY
UN	AH N
UN(2)	Y UW EH N
UNABASHED	AH N AH B AE SH T
UNABATED	AH N AH B EY T IH D
UNABLE	AH N EY B AH L
UNACCOUNTABLE	AH N AH K AW N T AH B AH L
UNACKNOWLEDGED	AH N AE K N AA L IH JH D
UNACQUAINTED	axn AX K W EY N T ed
UNAFFECTED	AH N AH F EH K T IH D
UNAFFECTEDLY	AH N AH F EH K T AH D L IY
UNALLIED	axn AE L AY D
UNALLOYED	AH N AE L OY D
UNALTERABLE	AH N AO L T ER AH B AH L
UNANSWERABLE	AH N AE N S ER AH B AH L
UNAPPEASABLE	axn AX P II S AX B xl
UNASKED	AH N AE S K T
UNASSAILED	axn AX S EY L D
UNASSUMING	AH N AH S UW M IH NG
UNATTENDED	AH N AH T EH N D IH D
UNAVAILING	AH N AH V EY L IH NG
UNAVOIDABLE	AH N AH V OY D AH B AH L
UNAVOIDABLY	AH N AH V OY D AH B L IY
UNAWARE	AH N AH W EH R
UNBECOMING	AH N B IH K AH M IH NG
UNBECOMING(2)	AH N B IY K AH M IH NG
UNBENDING	AH N B EH N D IH NG
UNBLEMISHED	AH N B L EH M IH SH T
UNCERTAIN	AH N S ER T AH N
UNCERTAINTY	AH N S ER T AH N T IY
UNCHANGED	AH N CH EY N JH D
UNCIVIL	AH N S IH V AH L
UNCLE	AH NG K AH L
UNCLE'S	AH NG K AH L Z
UNCLES	AH NG K AH L Z
UNCOMFORTABLE	AH N K AH M F ER T AH B AH L
UNCOMMON	AH N K AA M AH N
UNCOMMONLY	AH N K AA M AH N L IY
UNCOMPANIONABLE	axn K AX M P AE N I axn AX B AX L
UNCONCERN	AH N K AH N S ER N
UNCONCERNED	AH N K AH N S ER N D
UNCONNECTED	AH N K AH N EH K T IH D
UNCONSCIOUSLY	AH N K AA N SH AH S L IY
UNCONTROLLED	AH N K AH N T R OW L D
UNDECEIVE	AH N D IH S IY V
UNDECIDED	AH N D IH S AY D IH D
UNDER	AH N D ER
UNDERGONE	AH N D ER G AO N
UNDERSTAND	AH N D ER S T AE N D
UNDERSTANDING	AH N D ER S T AE N D IH NG
UNDERSTOOD	AH N D ER S T UH D
UNDERTAKEN	AH N D ER T EY K AH N
UNDERTAKING	AH N D ER T EY K IH NG
UNDERVALUED	AH N D ER V AE L Y UW D
UNDERVALUING	AH N D ER V AE L Y UW IH NG
UNDESERVED	AH N D IH Z ER V D
UNDESERVING	AH N D IH Z ER V IH NG
UNDETERMINED	AH N D IH T ER M IH N D
UNDETERMINED(2)	AH N D IY T ER M AH N D
UNDIMINISHED	AH N D AH M IH N IH SH T
UNDO	AH N D UW
UNDONE	AH N D AH N
UNDOUBTED	AH N D AW T IH D
UNDOUBTEDLY	AH N D AW T IH D L IY
UNDUTIFUL	axn D Y OO T I F U L
UNEASINESS	AH N IY Z IY N AH S
UNEASY	AH N IY Z IY
UNEMBARRASSED	AH N IH M B AE R AH S T
UNEQUAL	AH N IY K W AH L
UNEQUALLY	axn II K W AX L II
UNEXAMPLED	AH N IH G Z AE M P AH L D
UNEXPECTED	AH N IH K S P EH K T IH D
UNEXPECTEDLY	AH N IH K S P EH K T IH D L IY
UNFAVOURABLE	AH N F EY V ER AH B AH L
UNFAVOURABLY	axn F EY V ER EH B L II
UNFEELING	AH N F IY L IH NG
UNFELT	AH N F EH L T
UNFIT	AH N F IH T
UNFOLD	AH N F OW L D
UNFOLDED	AH N F OW L D AH D
UNFOLDING	AH N F OW L D IH NG
UNFORTUNATE	AH N F AO R CH AH N AH T
UNFORTUNATE(2)	AH N F AO R CH UW N AH T
UNFORTUNATELY	AH N F AO R CH AH N AH T L IY
UNFORTUNATELY(2)	AH N F AO R CH UW N AH T L IY
UNFREQUENTLY	AH N F R IY K W AH N T L IY
UNGENEROUS	AH N JH EH N ER AH S
UNGOVERNABLE	AH N G AH V ER N AH B AH L
UNGRACIOUS	AH N G R EY SH AH S
UNGRACIOUSNESS	axn G R EY SH AX S N EH S
UNGUARDED	AH N G AA R D IH D
UNHAPPILY	AH N HH AE P AH L IY
UNHAPPINESS	AH N HH AE P IY N IH S
UNHAPPY	AH N HH AE P IY
UNHEARD	AH N HH ER D
UNIFORM	Y UW N AH F AO R M
UNIFORMITY	Y UW N AH F AO R M AH T IY
UNIFORMLY	Y UW N AH F AO R M L IY
UNIMPORTANT	AH N IH M P AO R T AH N T
UNINTELLIGIBLE	AH N IH N T EH L AH JH AH B AH L
UNION	Y UW N Y AH N
UNITE	Y UW N AY T
UNITED	Y UW N AY T AH D
UNITED(2)	Y UW N AY T IH D
UNITING	Y UW N AY T IH NG
UNIVERSAL	Y UW N AH V ER S AH L
UNIVERSALLY	Y UW N AH V ER S AH L IY
UNIVERSITIES	Y UW N AH V ER S AH T IY Z
UNJUST	AH N JH AH S T
UNJUSTIFIABLE	AH N JH AH S T IH F AY AH B AH L
UNJUSTLY	AH N JH AH S T L IY
UNKINDNESS	AH N K AY N D N AH S
UNKNOWINGLY	AH N N OW IH NG L IY
UNKNOWN	AH N N OW N
UNLESS	AH N L EH S
UNLIKE	AH N L AY K
UNLIKELY	AH N L AY K L IY
UNLUCKILY	AH N L UW S IY L IY
UNLUCKY	AH N L AH K IY
UNMARKED	AH N M AA R K T
UNMOVED	AH N M UW V D
UNNATURAL	AH N N AE CH ER AH L
UNNATURALLY	AH N N AE CH ER AH L IY
UNNATURALLY(2)	AH N N AE CH ER L IY
UNNATURALLY(3)	AH N AE CH ER L IY
UNNATURALLY(4)	AH N N AE CH R AH L IY
UNNECESSARILY	AH N N EH S AH S EH R AH L IY
UNNECESSARY	AH N N EH S AH S EH R IY
UNPARDONABLE	AH N P AA R D AH N AH B AH L
UNPLEASANT	AH N P L EH Z AH N T
UNPLEASANTLY	AH N P L EH Z AH N T L IY
UNPLEASING	AH N P L IY Z IH NG
UNPREPARED	AH N P R IY P EH R D
UNPRETENDING	AH N P R IY T EH N D IH NG
UNPRINCIPLED	AH N P R IH N S AH P AH L D
UNPROFITABLE	AH N P R AA F IH T AH B AH L
UNPROTECTED	AH N P R AH T EH K T IH D
UNQUALIFIED	AH N K W AA L IH F AY D
UNQUESTIONABLY	AH N K W EH S CH AH N AH B L IY
UNREASONABLE	AH N R IY Z N AH B AH L
UNREASONABLY	AH N R IY Z AH N AH B L IY
UNRESERVE	AH N R IH Z ER V
UNRESERVED	AH N R IH Z ER V D
UNRESTRAINED	AH N R IY S T R EY N D
UNSELDOM	axn S EH L D AX M
UNSETTLED	AH N S EH T AH L D
UNSHACKLED	AH N SH AE K AH L D
UNSHAKEN	AH N SH EY K AH N
UNSOCIAL	axn S OW SH AX L
UNSTUDIED	AH N S T AH D IY D
UNSUBDUED	AH N S AH B D UW D
UNSUCCESSFULLY	AH N S AH K S EH S F AH L IY
UNSUITABLE	AH N S UW T AH B AH L
UNSUSPICIOUS	AH N S AH S P IH SH AH S
UNTAMED	axn T EY M D
UNTIDY	AH N T AY D IY
UNTIL	AH N T IH L
UNTINCTURED	axn T I ng K CH ER D
UNTITLED	axn T AY T xl D
UNTOUCHED	AH N T AH CH T
UNUSUAL	AH N Y UW ZH AH W AH L
UNUSUAL(2)	AH N Y UW ZH UW AH L
UNUSUAL(3)	AH N Y UW ZH W AH L
UNVARYING	AH N V EH R IY IH NG
UNWEARYING	axn W II ER II ng
UNWELCOME	AH N W EH L K AH M
UNWELL	AH N W EH L
UNWILLING	AH N W IH L IH NG
UNWILLINGLY	AH N W IH L IH NG L IY
UNWILLINGNESS	AH N W IH L IH NG N IH S
UNWORTHILY	axn W ER DH I L II
UNWORTHY	AH N W ER DH IY
UP	AH P
UPBRAIDED	AH P B R EY D IH D
UPBRAIDING	axn B R EY D I ng
UPON	AH P AA N
UPPER	AH P ER
UPPERMOST	AH P ER M OW S T
UPROAR	AH P R AO R
UPSTAIRS	AH P S T EH R Z
UPSTART	AH P S T AA R T
URGED	ER JH D
URGENT	ER JH AH N T
US	AH S
US(2)	Y UW EH S
USAGE	Y UW S AH JH
USAGE(2)	Y UW S IH JH
USE	Y UW S
USE(2)	Y UW Z
USED	Y UW Z D
USEFUL	Y UW S F AH L
USELESS	Y UW S L AH S
USELESSLY	Y UW S L AH S L IY
USING	Y UW Z IH NG
USUAL	Y UW ZH AH W AH L
USUAL(2)	Y UW ZH UW AH L
USUALLY	Y UW ZH AH W AH L IY
USUALLY(2)	Y UW ZH AH L IY
UTMOST	AH T M OW S T
UTTER	AH T ER
UTTERED	AH T ER D
UTTERLY	AH T ER L IY
VACANCY	V EY K AH N S IY
VACANT	V EY K AH N T
VAGUE	V EY G
VAIN	V EY N
VALID	V AE L AH D
VALID(2)	V AE L IH D
VALLEY	V AE L IY
VALUABLE	V AE L Y AH B AH L
VALUABLE(2)	V AE L Y UW B AH L
VALUE	V AE L Y UW
VALUED	V AE L Y UW D
VALUELESS	V AE L Y UW L AH S
VANISH	V AE N IH SH
VANISHED	V AE N IH SH T
VANITY	V AE N AH T IY
VANITY(2)	V AE N IH T IY
VARIANCE	V EH R IY AH N S
VARIATION	V EH R IY EY SH AH N
VARIED	V EH R IY D
VARIETIES	V ER AY AH T IY Z
VARIETY	V ER AY AH T IY
VARIOUS	V EH R IY AH S
VARY	V EH R IY
VARYING	V EH R IY IH NG
VAST	V AE S T
VASTLY	V AE S T L IY
VEHEMENCE	V IY AH M AH N S
VEHEMENCE(2)	V AH HH IY M AH N S
VENERATION	V EH N ER EY SH AH N
VENISON	V EH N AH S AH N
VENT	V EH N T
VENTING	V EH N T IH NG
VENTURE	V EH N CH ER
VENTURED	V EH N CH ER D
VENTURING	V EH N CH ER IH NG
VERACITY	V ER AE S IH T IY
VERDURE	V ER JH ER
VERILY	V EH R I L II
VERSES	V ER S AH Z
VERSES(2)	V ER S IH Z
VERY	V EH R IY
VESTIBULE	V EH S T IH B Y UW L
VEX	V EH K S
VEXATION	V EH K S EY SH AH N
VEXATIONS	V EH K S EY SH axn S
VEXATIOUS	V EH K S EY SH AH S
VEXED	V EH K S T
VEXING	V EH K S IH NG
VICE	V AY S
VICES	V AY S AH Z
VICES(2)	V AY S IH Z
VICINITY	V AH S IH N AH T IY
VICINITY(2)	V IH S IH N IH T IY
VICIOUS	V IH SH AH S
VICTIM	V IH K T AH M
VICTIM(2)	V IH K T IH M
VICTORY	V IH K T ER IY
VICTORY(2)	V IH K T R IY
VIEW	V Y UW
VIEWING	V Y UW IH NG
VIEWS	V Y UW Z
VIGOROUSLY	V IH G ER AH S L IY
VIGOUR	V IH G AH R
VILLAGE	V IH L AH JH
VILLAGE(2)	V IH L IH JH
VILLAINOUS	V IH L AH N AH S
VINDICATION	V IH N D AH K EY SH AH N
VINGT	V I ng K T
VIOLATED	V AY AH L EY T IH D
VIOLATION	V AY AH L EY SH AH N
VIOLENCE	V AY AH L AH N S
VIOLENT	V AY AH L AH N T
VIOLENT(2)	V AY L AH N T
VIOLENTLY	V AY AH L AH N T L IY
VIOLENTLY(2)	V AY L AH N T L IY
VIRTUE	V ER CH UW
VISIBLE	V IH Z AH B AH L
VISIT	V IH Z AH T
VISIT(2)	V IH Z IH T
VISITED	V IH Z AH T AH D
VISITED(2)	V IH Z IH T IH D
VISITING	V IH Z AH T IH NG
VISITING(2)	V IH Z IH T IH NG
VISITOR	V IH Z AH T ER
VISITOR(2)	V IH Z IH T ER
VISITORS	V IH Z AH T ER Z
VISITORS(2)	V IH Z IH T ER Z
VISITS	V IH Z AH T S
VISITS(2)	V IH Z IH T S
VIVACITY	V AH V AE S AH T IY
VOGUE	V OW G
VOICE	V OY S
VOID	V OY D
VOLATILITY	V AA L AH T IH L AH T IY
VOLUBILITY	V AA L AH B IH L AH T IY
VOLUME	V AA L Y UW M
VOLUNTARILY	V AA L AH N T EH R AH L IY
VOLUNTARY	V AA L AH N T EH R IY
VOLUNTEER	V AA L AH N T IH R
VOUCH	V AW CH
VOUCHSAFED	V AW CH S EY F T
VOW	V AW
VOWS	V AW Z
VULGAR	V AH L G ER
VULGARITY	V AH L G EH R IH T IY
W	D AH B AH L Y UW
WAIT	W EY T
WAITED	W EY T AH D
WAITED(2)	W EY T IH D
WAITER	W EY T ER
WAITING	W EY T IH NG
WAIVED	W EY V D
WAKING	W EY K IH NG
WALK	W AO K
WALK(2)	W AA K
WALKED	W AO K T
WALKER	W AO K ER
WALKING	W AO K IH NG
WALKS	W AO K S
WANDER	W AA N D ER
WANDERED	W AA N D ER D
WANDERING	W AA N D ER IH NG
WANT	W AA N T
WANT(2)	W AO N T
WANTED	W AA N T AH D
WANTED(2)	W AO N T IH D
WANTED(3)	W AO N IH D
WANTING	W AA N T IH NG
WANTING(2)	W AA N IH NG
WANTONLY	W AO N T AH N L IY
WANTONLY(2)	W AA N T AH N L IY
WANTS	W AA N T S
WANTS(2)	W AO N T S
WAR	W AO R
WARD	W AO R D
WARDED	W AO R D IH D
WAREHOUSES	W EH R HH AW Z IH Z
WAREHOUSES(2)	W EH R HH AW S IH Z
WARM	W AO R M
WARMEST	W AO R M AH S T
WARMLY	W AO R M L IY
WARMTH	W AO R M TH
WARN	W AO R N
WARNED	W AO R N D
WARRANT	W AO R AH N T
WARWICK	W AO R W IH K
WAS	W AA Z
WAS(2)	W AH Z
WAS(3)	W AO Z
WASTE	W EY S T
WASTING	W EY S T IH NG
WATCH	W AA CH
WATCH(2)	W AO CH
WATCHED	W AA CH T
WATCHED(2)	W AO CH T
WATCHES	W AA CH AH Z
WATCHES(2)	W AA CH IH Z
WATCHFUL	W AA CH F AH L
WATCHFULNESS	W AA CH F AH L N AH S
WATCHING	W AA CH IH NG
WATER	W AO T ER
WATERING	W AO T ER IH NG
WATSON'S	W AA T S AH N Z
WAVE	W EY V
WAVERED	W EY V ER D
WAVERING	W EY V ER IH NG
WAY	W EY
WAYS	W EY Z
WE	W IY
WEAK	W IY K
WEAKENED	W IY K AH N D
WEAKEST	W IY K AH S T
WEAKNESS	W IY K N AH S
WEAKNESSES	W IY K N AH S AH Z
WEAKNESSES(2)	W IY K N AH S IH Z
WEALTH	W EH L TH
WEAR	W EH R
WEARIED	W IH R IY D
WEARISOME	W IH R IY S AH M
WEARS	W EH R Z
WEARY	W IH R IY
WEATHER	W EH DH ER
WEBBS	W EH B Z
WEDDING	W EH D IH NG
WEDNESDAY	W EH N Z D IY
WEDNESDAY(2)	W EH N Z D EY
WEEK	W IY K
WEEKS	W IY K S
WEEP	W IY P
WEIGHED	W EY D
WEIGHT	W EY T
WEIGHTY	W EY T IY
WELCOME	W EH L K AH M
WELCOMED	W EH L K AH M D
WELCOMING	W EH L K AH M IH NG
WELFARE	W EH L F EH R
WELL	W EH L
WENT	W EH N T
WERE	W ER
WEST	W EH S T
WESTERHAM	W EH S T ER HH AE M
WET	W EH T
WHAT	W AH T
WHAT(2)	HH W AH T
WHAT'S	W AH T S
WHAT'S(2)	HH W AH T S
WHATEVER	W AH T EH V ER
WHATEVER(2)	HH W AH T EH V ER
WHEN	W EH N
WHEN(2)	HH W EH N
WHEN(3)	W IH N
WHEN(4)	HH W IH N
WHENCE	W EH N S
WHENCE(2)	HH W EH N S
WHENEVER	W EH N EH V ER
WHENEVER(2)	HH W EH N EH V ER
WHERE	W EH R
WHERE(2)	HH W EH R
WHEREVER	W EH R EH V ER
WHEREVER(2)	HH W EH R EH V ER
WHETHER	W EH DH ER
WHETHER(2)	HH W EH DH ER
WHICH	W IH CH
WHICH(2)	HH W IH CH
WHICHEVER	W IH CH EH V ER
WHICHEVER(2)	HH W IH CH EH V ER
WHILE	W AY L
WHILE(2)	HH W AY L
WHILST	W AY L S T
WHIMS	W IH M Z
WHIMS(2)	HH W IH M Z
WHIMSICAL	W IH M Z IH K AH L
WHIMSICAL(2)	HH W IH M Z IH K AH L
WHISPER	W IH S P ER
WHISPER(2)	HH W IH S P ER
WHISPERED	W IH S P ER D
WHISPERED(2)	HH W IH S P ER D
WHISPERING	W IH S P ER IH NG
WHISPERING(2)	HH W IH S P ER IH NG
WHIST	W IH S T
WHITE	W AY T
WHITE(2)	HH W AY T
WHITHER	W IH DH ER
WHITHER(2)	HH W IH DH ER
WHO	HH UW
WHOLE	HH OW L
WHOLLY	HH OW L IY
WHOM	HH UW M
WHOSE	HH UW Z
WHY	W AY
WHY(2)	HH W AY
WICKEDEST	W I K EH D EH S T
WICKEDNESS	W IH K AH D N AH S
WICKHAM	W IH K AH M
WICKHAM'S	W I K HH AE M S
WIDE	W AY D
WIDELY	W AY D L IY
WIDOW	W IH D OW
WIFE	W AY F
WIFE'S	W AY F S
WILD	W AY L D
WILDERNESS	W IH L D ER N AH S
WILFUL	W IH L F AH L
WILFULLY	W IH L F AH L IY
WILL	W IH L
WILL(2)	W AH L
WILLED	W IH L D
WILLFULLY	W IH L F AH L IY
WILLIAM	W IH L Y AH M
WILLIAM'S	W IH L Y AH M Z
WILLING	W IH L IH NG
WILLINGLY	W IH L IH NG L IY
WILLINGNESS	W IH L IH NG N AH S
WIN	W IH N
WIND	W AY N D
WIND(2)	W IH N D
WINDING	W AY N D IH NG
WINDINGS	W AY N D I ng Z
WINDOW	W IH N D OW
WINDOWS	W IH N D OW Z
WINE	W AY N
WINK	W IH NG K
WINKING	W IH NG K IH NG
WINTER	W IH N T ER
WISDOM	W IH Z D AH M
WISE	W AY Z
WISELY	W AY Z L IY
WISER	W AY Z ER
WISEST	W AY Z AH S T
WISH	W IH SH
WISHED	W IH SH T
WISHER	W IH SH ER
WISHES	W IH SH IH Z
WISHING	W IH SH IH NG
WIT	W IH T
WITH	W IH DH
WITH(2)	W IH TH
WITHDRAWING	W IH TH D R AO IH NG
WITHDRAWING(2)	W IH DH D R AO IH NG
WITHDRAWN	W IH TH D R AO N
WITHDRAWN(2)	W IH DH D R AO N
WITHDREW	W IH TH D R UW
WITHDREW(2)	W IH DH D R UW
WITHHELD	W IH TH HH EH L D
WITHIN	W IH DH IH N
WITHIN(2)	W IH TH IH N
WITHOUT	W IH TH AW T
WITHOUT(2)	W IH DH AW T
WITHSTOOD	W IH TH S T UH D
WITNESS	W IH T N AH S
WITNESSED	W IH T N AH S T
WITNESSING	W IH T N AH S IH NG
WITS	W IH T S
WITTICISMS	W IH T IH K S IH Z AH M Z
WITTY	W IH T IY
WIVES	W AY V Z
WOE	W OW
WOMAN	W UH M AH N
WOMAN'S	W UH M AH N Z
WOMANLY	W UH M AH N L IY
WOMEN	W IH M AH N
WOMEN'S	W IH M AH N Z
WON	W AH N
WON(2)	W AA N
WONDER	W AH N D ER
WONDERED	W AH N D ER D
WONDERFUL	W AH N D ER F AH L
WONDERFULLY	W AH N D ER F AH L IY
WONDERFULLY(2)	W AH N D ER F L IY
WONDERING	W AH N D ER IH NG
WONDERS	W AH N D ER Z
WOOD	W UH D
WOODS	W UH D Z
WOODY	W UH D IY
WORD	W ER D
WORDS	W ER D Z
WORE	W AO R
WORK	W ER K
WORKED	W ER K T
WORLD	W ER L D
WORLDLY	W ER L D L IY
WORN	W AO R N
WORSE	W ER S
WORST	W ER S T
WORTH	W ER TH
WORTHLESS	W ER TH L AH S
WORTHLESSNESS	W ER TH L EH S N EH S
WORTHY	W ER DH IY
WOULD	W UH D
WOUND	W AW N D
WOUND(2)	W UW N D
WOUNDED	W UW N D AH D
WOUNDED(2)	W UW N D IH D
WOUNDING	W UW N D IH NG
WRETCHED	R EH CH IH D
WRETCHEDLY	R EH CH IH D L IY
WRETCHEDNESS	R EH CH AH D N AH S
WRITE	R AY T
WRITER	R AY T ER
WRITES	R AY T S
WRITING	R AY T IH NG
WRITTEN	R IH T AH N
WRONG	R AO NG
WROTE	R OW T
YARDS	Y AA R D Z
YAWN	Y AO N
YAWNED	Y AO N D
YAWNING	Y AO N IH NG
YEAR	Y IH R
YEARS	Y IH R Z
YEARS(2)	Y ER Z
YES	Y EH S
YESTERDAY	Y EH S T ER D EY
YESTERDAY(2)	Y EH S T ER D IY
YET	Y EH T
YIELD	Y IY L D
YIELDED	Y IY L D AH D
YIELDED(2)	Y IY L D IH D
YIELDING	Y IY L D IH NG
YORK	Y AO R K
YOU	Y UW
YOUNG	Y AH NG
YOUNGE	Y AH N JH
YOUNGER	Y AH NG G ER
YOUNGEST	Y AH NG G AH S T
YOUR	Y AO R
YOUR(2)	Y UH R
YOURS	Y UH R Z
YOURS(2)	Y AO R Z
YOURS(3)	Y ER Z
YOURSELF	Y ER S EH L F
YOURSELF(2)	Y UH R S EH L F
YOURSELF(3)	Y AO R S EH L F
YOURSELVES	Y UH R S EH L V Z
YOURSELVES(2)	Y AO R S EH L V Z
YOUTH	Y UW TH
YOUTHS	Y UW DH Z
YOUTHS(2)	Y UW TH S
